[Sound effect number 6 here.]
Harry Potter and the Philosopher's stone
Influenced by "Harry Potter and the Philosopher's stone" by J.K. Rowling. by Orion Zymaris
Release 1 / Serial number 131218 / Inform 7 build 6G60 (I6/v6.32 lib 6/12N) SD

Welcome to An Interactive Fiction version of Harry Potter.
                (If you ever need help, type help.)

When Mr and Mrs Dursley woke up on the dull, grey Tuesday our story starts, there was nothing about the cloudy sky outside to suggest that strange and mysterious things would soon be happening all over the country.

Mrs Dursley goes downstairs and says "You should get ready for work dear!"
Harry Potter and the Philosopher's stone
Influenced by "Harry Potter and the Philosopher's stone" by J.K. Rowling. by Orion Zymaris
Release 1 / Serial number 131218 / Inform 7 build 6G60 (I6/v6.32 lib 6/12N) SD

Dursley's bedroom (in bed)
You look around. There is a wardrobe, a bed, a bedside table with drawer attached, and a door to the north-west.

You can see the bedroom door (northwest), bedroom window (providing light), a clock, Wardrobe (closed) and bedside table here.

Name:

>go through do
Your name for this pre-release test is "go through do".

>go through door
You'll have to get out of bed first.

>get up
You get out of bed.

Dursley's bedroom
You look around. There is a wardrobe, a bed, a bedside table with drawer attached, and a door to the east.

You can see bedroom door (east), bedroom window (providing light), bed (empty), a clock, Wardrobe (closed) and bedside table here.

I beg your pardon?

>e
(first opening bedroom door)

hall
As you enter the hall, you see a white door to the north,a latched panel in the roof,a cupboard to the east and the bedroom door to the west.

You can see white door (north), a latched panel (up) and bedroom door (west) here.

>quit
Save failed.

Are you sure you want to quit?

>t
Please answer yes or no.

* * *

>Orion
Your name for this pre-release test is "Orion".

>look
Dursley's bedroom (in bed)
You look around. There is a wardrobe, a bed, a bedside table with drawer attached, and a door to the north-west.

You can see the bedroom door (northwest), bedroom window (providing light), a clock, Wardrobe (closed) and bedside table here.

>error report
This game's error reports:

* * *

>player reports
I didn't understand that sentence.

>player report
Action: looking 

Game tester: Orion
Command: look
Action: looking 

Game tester: Orion
Command: error report
Action: error report retrieving 

Game tester: Orion
Command: all player reports
Action: reading player command report 

Game tester: Orion
Command: player reports
Game tester: Orion
Command: player report
Action: reading current player command report

>report error
Error noted.

>error report
This game's error reports:
Error 2:

>report error "Hello"
Error noted.

>error report
This game's error reports:
Error 2: Error 2: "hello"

>error report
This game's error reports:
Error 2: Error 2: "hello"

>report error "Hello"
Error noted.

>error report
This game's error reports:
Error 2: Error 2: "hello"
Error 3: "hello"

* * *

>look
Dursley's bedroom (in bed)
You look around. There is a wardrobe, a bed, a bedside table with drawer attached, and a door to the north-west.

You can see the bedroom door (northwest), bedroom window (providing light), a clock, Wardrobe (closed) and bedside table here.

>gonear shop
The Baker's
You can see a shop door (west), a Shop attendant and a foods display case (closed) (in which are a doughnut, a bun, a breadstick and two small rolls) here.

>open case
That's not something you can open.

>close case
That's not something you can close.

>eat all
You can't use multiple objects with that verb.

>eat case
That's plainly inedible.

>eat me
You're plainly inedible.

* * *

>gonear shop
The Baker's
You can see a shop door (west), a Shop attendant and a foods display case (closed) (in which are a doughnut, a bun, a breadstick and two small rolls) here.

>take all
doughnut: The foods display case isn't open.
bun: The foods display case isn't open.
breadstick: The foods display case isn't open.
small roll: The foods display case isn't open.
small roll: The foods display case isn't open.

>hello
(addressing the Shop attendant)
You say hello to the Shop attendant.

>talk
What do you want to talk to?

>talk to shop attendant
You are already talking to the Shop attendant.

>eat shop
He's plainly inedible.

>eat roll
The foods display case isn't open.

>take roll
The foods display case isn't open.

>give me a roll
"You need to pay for that. That'll be a pound."

>ok
That was a rhetorical question.

>i
You are carrying two pound coins. You are wearing a watch and Pyjamas.

>give one cooin
You can't see any such thing.

>give one coin
(to the Shop attendant)
You give the pound coin to the Shop attendant.

>give me a roll
"You need to pay for that. That'll be a pound."

>stats
dialyes/no is 0
lexicon current table is Table 1 - customer responses
the venture of customercall is incomplete
office phone is not Inuse
The venture of mrmason call is incomplete
mobilel is not inuse
last turn's action was giving the pound coin to the Shop attendant
Bored is 12
The three digit number lock is 389
The tumblers are 000
the venture of work is incomplete
added score is 0
player's command: stats
Play success is 0
The location is The Baker's
Current region is nothing
Credit is 0
venture of work is incomplete
Remembered product is small roll

>pay pound
(to the Shop attendant)
You give the pound coin to the Shop attendant.

>stats
dialyes/no is 0
lexicon current table is Table 1 - customer responses
the venture of customercall is incomplete
office phone is not Inuse
The venture of mrmason call is incomplete
mobilel is not inuse
last turn's action was giving the pound coin to the Shop attendant
Bored is 14
The three digit number lock is 389
The tumblers are 000
the venture of work is incomplete
added score is 0
player's command: stats
Play success is 0
The location is The Baker's
Current region is nothing
Credit is 0
venture of work is incomplete
Remembered product is small roll

>restart
Save failed.

Are you sure you want to restart?

>y
*** Run-time problem P31: Attempt to use a property of the 'nothing' non-object: property map region

Harry Potter and the Philosopher's stone
Based on "Harry Potter and the Philosopher's stone" by J.K. Rowling. by Orion Zymaris
Release 1 / Serial number 130321 / Inform 7 build 6G60 (I6/v6.32 lib 6/12N) SD

Welcome to An Interactive Fiction version of Harry Potter.
                (If you ever need help, type help.)

Mr and Mrs Dursley, of number four, Privet Drive, were proud to say that they were perfectly normal, thank you very much. They were the last people you'd expect to be involved in anything strange or mysterious,  because they, or rather you, just didn't hold with such nonsense.

As you wake up, on a dull, grey Tuesday, you can hardly imagine that soon strange things would be happening all over the country.
You are Mr  Vernon Dursley, and are in your bedroom.

Dursley's bedroom (in bed)
You look around. There is a wardrobe, a bed, a bedside table with drawer attached, and a door to the east.

You can see bedroom door (east), bedroom window (providing light), a clock, Wardrobe (closed) and bedside table here.

Name:

>Orion
Your name for this pre-release test is "Orion".

>gonear street
street
You can see a shop door (east) here.

>e
(first opening the door)
"Good morning! How may i help you, sir?" asks the shop attendant.

>rules
Rules tracing now switched on. Type "rules off" to switch it off again, or "rules all" to include even rules which do not apply.

>buy roll
[Rule "before buying anything when in bakers" applies.]
[Rule "before giving something in foods display case to the player when in bakers" applies.]
"You need to pay for that. That'll be a pound."

[Rule "every turn during uncle vernon's scene" applies.]
[Rule "every turn during uncle vernon's scene" applies.]
[Rule "every turn during uncle vernon's scene" applies.]
[Rule "every turn during uncle vernon's scene" applies.]
[Rule "every turn during uncle vernon's scene" applies.]
[Rule "every turn during uncle vernon's scene" applies.]

>pay coin
(to the Shop attendant)
[Rule "before doing anything" applies.]
[Rule "before doing anything" applies.]
[Rule "before doing anything" applies.]
[Rule "before doing anything" applies.]
[Rule "can't give what you haven't got rule" applies.]
[Rule "can't give to yourself rule" applies.]
[Rule "can't give to a non-person rule" applies.]
[Rule "can't give clothes being worn rule" applies.]
[Rule "standard giving rule" applies.]
[Rule "after doing anything except clearing player command report" applies.]
[Rule "standard report giving rule" applies.]
You give the pound coin to the Shop attendant.

[Rule "every turn during uncle vernon's scene" applies.]
[Rule "every turn during uncle vernon's scene" applies.]
[Rule "every turn during uncle vernon's scene" applies.]
[Rule "every turn during uncle vernon's scene" applies.]
[Rule "every turn during uncle vernon's scene" applies.]
[Rule "every turn during uncle vernon's scene" applies.]

* * *

>look
Dursley's bedroom (in bed)
You look around. There is a wardrobe, a bed, a bedside table with drawer attached, and a door to the north-west.

You can see the bedroom door (northwest), bedroom window (providing light), a clock, Wardrobe (closed) and bedside table here.

>eat me
You're plainly inedible.

>remove window from play
You can't see any such thing.

>cheats on
Now cheats are on.

>remove window from play
you remove bedroom window from play.

It is now pitch dark in here!

>put bedroom window back in dursley's bedroom
You move the bedroom window back to the Dursley's bedroom.

Dursley's bedroom (in bed)
You look around. There is a wardrobe, a bed, a bedside table with drawer attached, and a door to the east.

You can see bedroom window (providing light), bedroom door (east), a clock, Wardrobe (closed) and bedside table here.

>move bed to me
Dursley's bedroom
You look around. There is a wardrobe, a bed, a bedside table with drawer attached, and a door to the east.

You can see bedroom window (providing light), bedroom door (east), bed (empty), a clock, Wardrobe (closed) and bedside table here.

You move bed to yourself.

>look
Dursley's bedroom
You look around. There is a wardrobe, a bed, a bedside table with drawer attached, and a door to the east.

You can see bedroom window (providing light), bedroom door (east), a clock, Wardrobe (closed) and bedside table here.

* * *

>look
Dursley's bedroom (in bed)
You look around. There is a wardrobe, a bed, a bedside table with drawer attached, and a door to the north-west.

You can see the bedroom door (northwest), bedroom window (providing light), a clock, Wardrobe (closed) and bedside table here.

>test me
"Can I order another 50 drills? the last ones where excellent."

>[53] wait
Time passes.

>[54] sure
"That's great. Now, what drills would you reccomend for it's low price?"

>[55] try the hal 6502
"That doesn't sound right... I think that range is suited for something else."

>[56] wait
Time passes.

>[57] hmmm...
That's not a verb I recognise.

>[58] read dex
Tuesday
Work for today:

Answer one customer phone call: achieved
Get huge order from Mr. Mason.

>[59] flip dex
you flip the rollerdex to a random page.

>[60] read dex
Saturday October 11th 1997

Call Xander at 5550168

Mr. Mason gets bored and hangs up. "If you remember, call me at 12856."

You say goodbye to Mr. Mason.

>[61] call 5552368
(on the office phone)

Who you gonna call? obviously not the ghost busters. They must be out of business.
>[62] take pen
You take pen from desk.

>[63] write on notepad

What do you want to write: [64] write major irrelivancies
You write "major irrelivancies"
>[65] s

corridor
You can see an office door (north), stairs (down) and elevator (in which is elevator button) here.

>[66] press button
Since you pressed the button without getting in, you have to wait for the elevator to come back to the corridor.

The elevator comes back to the corridor with a soft pinging noise.

>[67] wait
Time passes.

>[68] get in elevator
You get into elevator.

In elevator you can see elevator button.

>[69] press button
You go down the elevator, back to the carpark.

Grunnings Carpark (in elevator)
You can see stairs (up), red car (closed), blue car (closed), rainbow car (closed) and green car (closed) here.

In elevator you can see elevator button.

>[70] get out
You get out of elevator.

Grunnings Carpark
You can see stairs (up), elevator (in which is elevator button), red car (closed), blue car (closed), rainbow car (closed) and green car (closed) here.

>[71] carjack red car
You smash open the windows with a satisfying, and very loud, noise of breaking glass.

>[72] get in red car
You can't get into the closed red car.

>[73] e
it's a bit too long of a journey to walk all the way to work.

>[74] cheats on
Now cheats are on.
>[75] teleport to street
You appear in street.

>[76] go through shop door
(first opening the door)

The Baker's
You can see a shop door (west), magic door, Shop attendant and Foods display case (closed) (in which are a donut, a bun, a breadstick and two small rolls) here.

>[77] stats
dialyes/no is 0
lexicon current table is Table 1 - customer responses
the venture of customercall is success
office phone is not Inuse
The venture of mrmason call is incomplete
mobilel is not inuse
last turn's action was opening a shop door (west)
Bored is 16
The three digit number lock is 964
The tumblers are 000
the venture of work is incomplete
added score is 0
player's command: stats
Play success is 0
>[78] look at shop attendant
The nametag reads "Hello! My Name is irrelevant".

>look
The Baker's
You can see a shop door (west), Shop attendant and Foods display case (closed) (in which are a donut, a bun, a breadstick and two small rolls) here.

>hello
(addressing Shop attendant)
You say hello to Shop attendant.

* * *

>look
Dursley's bedroom (in bed)
You look around. There is a wardrobe, a bed, a bedside table with drawer attached, and a door to the north-west.

You can see the bedroom door (northwest), bedroom window (providing light), a clock, Wardrobe (closed) and bedside table here.

>all error reports
All error reports:
Game tester: Con. Error 3: says out of a product before it has been sold
Game tester: Orion. Error 1: "year for rolodex is wrong, says 1997."

>cheats on
Now cheats are on.

>eat me
You manage to eat yourself. You are in darkness.

Darkness
It is pitch dark, and you can't see a thing.

>look
You can't do anything here except undo.

>hhdf
You can't do anything here except undo.

>sdfgh
You can't do anything here except undo.

>sdfggfdfg
You can't do anything here except undo.

>get up
You can't do anything here except undo.

>gonear work
You can't do anything here except undo.

>gonear work
You can't do anything here except undo.

>undo
Darkness
[Previous turn undone.]

>undo
Darkness
[Previous turn undone.]

>undo
Dursley's bedroom
[Previous turn undone.]

>look
Dursley's bedroom (in bed)
You look around. There is a wardrobe, a bed, a bedside table with drawer attached, and a door to the east.

You can see bedroom door (east), bedroom window (providing light), a clock, Wardrobe (closed) and bedside table here.

>take all
There are none at all available!

>take clock
You take the clock from Dursley's bedroom.

>read clock
Hmm... The time is twenty-five to eight... I have work at 8:30.

>apparate to work
You appear in Work office.

>look
Work office
as you enter your office, you see your desk, with a phone on it.

You can see an office door (south), desk (on which are an office phone, an important customer service document, a rolodex, notepad, pen and two pound coins), a window, office chair and a filing cabinet here.

>take all
the important customer service document: You take the important customer service document from desk.
a rolodex: while taking a rolodex, you inadvertantly flip the rollerdex to a random page.
notepad: You take notepad from desk.
pen: You take pen from desk.
pound coin: You take the pound coin from desk.
pound coin: You take the pound coin from desk.

>apparate to shop
That noun did not make sense in this context.

>apparate to bakers
You appear in The Baker's.

>look
The Baker's
You can see a shop door (west), a Shop attendant and a foods display case (closed) (in which are a doughnut, a bun, a breadstick and two small rolls) here.

>buy roll
"You need to pay for that. That'll be a pound."

>take roll
You take the small roll from the foods display case.

>i
You are carrying:
  magic door
  a small roll
  two pound coins
  pen
  notepad
  an important customer service document
  a clock
  a watch (being worn)
  Pyjamas (being worn)

>pay one pound
(to the Shop attendant)
You give the pound coin to the Shop attendant.

>take all
pound coin: You take the pound coin from the Shop attendant.
doughnut: You take doughnut from the foods display case.
bun: You take bun from the foods display case.
breadstick: You take breadstick from the foods display case.
small roll: You take the small roll from the foods display case.

>i
You are carrying:
  magic door
  two small rolls
  breadstick
  bun
  doughnut
  two pound coins
  pen
  notepad
  an important customer service document
  a clock
  a watch (being worn)
  Pyjamas (being worn)

>move all to me
magic door: You move magic door to yourself.

small roll: You move the small roll to yourself.

breadstick: You move breadstick to yourself.

bun: You move bun to yourself.

doughnut: You move doughnut to yourself.

pound coin: You move the pound coin to yourself.

small roll: You move the small roll to yourself.

pound coin: You move the pound coin to yourself.

pen: You move pen to yourself.

notepad: You move notepad to yourself.

an important customer service document: You move an important customer service document to yourself.

clock: You move the clock to yourself.

a shop door (west): You move a shop door (west) to yourself.

Shop attendant: You move the Shop attendant to yourself.

foods display case: You move the foods display case to yourself.

* * *

>look
Dursley's bedroom (in bed)
You look around. There is a wardrobe, a bed, a bedside table with drawer attached, and a door to the north-west.

You can see the bedroom door (northwest), bedroom window (providing light), a clock, Wardrobe (closed) and bedside table here.

>cheats on
Now cheats are on.

>help
> General Game Commands (for specific hints, type hints)
   What does that top bar do?
   Acknowledgements
   Cheats

>[down]
General Game Commands (for specific hints, type hints)
 > What does that top bar do?
   Acknowledgements
   Cheats

   General Game Commands (for specific hints, type hints)
 > What does that top bar do?
   Acknowledgements
   Cheats

* * *

>Orion
Your name for this pre-release test is "Orion".

>get up
You get out of bed.

Dursley's bedroom
You look around. There is a wardrobe, a bed, a bedside table with drawer attached, and a door to the north-west.

You can see the bedroom door (northwest), bedroom window (providing light), bed (empty), a clock, Wardrobe (closed) and bedside table here.

>nw
Maybe you should wear something else before going.

>nw
Are you sure? Do you want to go out in your pyjamas?

>nw
Ok then. On your head be it.

(first opening the door)
Landing
The landing is gleaming, scrubbed and well kept, courtesy of Petunia.

You can see Dudley's second room's door (northeast), Dudley's bedroom door (northwest), a latched panel in the ceiling (up), the staircase (down) and the bedroom door (southeast) here.

>u
(first opening the door)
You pull on the panel, lowering a set of stairs to the ground that lead to the roof.

attic
As you enter the attic, you see pictures of Dudley all over the walls.

You can see a latched panel in the ceiling (down), Dudley's pictures, dusty box (closed), Petunia's diary and light (providing light) here.

>close stairs
You close Attic stairs.

>look
attic
As you enter the attic, you see pictures of Dudley all over the walls.

You can see Attic stairs (down), Dudley's pictures, dusty box (closed), Petunia's diary and light (providing light) here.

>turn off light
That's not something you can switch.

* * *

>nw
Maybe you should wear something else before going.

>open wardrobe
You open Wardrobe, revealing a mirror, wizards robes, a suit, a muumuu and a tutu.

>wear robes
You take off your pyjamas and put them away.

(first taking wizards robes)
You put on wizards robes.

>look in mirror
You look in the mirror and see your reflection. That is spectacular. Nice and flashy. Just what you were looking for.

>look
Dursley's bedroom
You look around. There is a wardrobe, a bed, a bedside table with drawer attached, and a door to the north-west.

You can see the bedroom door (northwest), bedroom window (providing light), bed (empty), a clock, Wardrobe (in which are Pyjamas, a mirror, a suit, a muumuu and a tutu) and bedside table here.

>nw
(first opening the door)

Landing
The landing is gleaming, scrubbed and well kept, courtesy of Petunia.

You can see Dudley's second room's door (northeast), Dudley's bedroom door (northwest), a latched panel in the ceiling (up), the staircase (down) and the bedroom door (southeast) here.

>down
(wizards robes)
You can't go that way.

>d
Hall
You can see Dudley's fingermarks all over the walls here. He frequents the hall, conveniently placed as it is in between the television and the fridge. 

You can see the living-room door (south), the dining room door (southwest), the front door (east), the kitchen door (west), the cupboard door (north) and the staircase (up) here.

>e
(first opening the door)

Garden
You look around and see a driveway with the car on it, the garage where the car came out of, and the highway to the north. The rest of privet drive is to the east.

You can see the front door (west), Cat, garage (closed) and a car (closed and empty) here.

>open car
It seems to be locked.

Hmm... I think the car keys are in my suitcase.

>w
Hall
You can see Dudley's fingermarks all over the walls here. He frequents the hall, conveniently placed as it is in between the television and the fridge. 

You can see the front door (east), the kitchen door (west), the cupboard door (north), the staircase (up), the living-room door (south) and the dining room door (southwest) here.

>w
"Are you ready for work dear?" Says Petunia.

>yed
That's not a verb I recognise.

>yes
You need to specify who you want to speak to.

>talk to petunia
"Good morning. How did you sleep?" Asks Petunia.

"Since there's Cereal all over the place, can you go get the broom and clean it up?"

>bye
You say goodbye to Petunia.

>say hello to petunia
"Good morning" Says Petunia.

>look
kitchen
You look around the kitchen and see Petunia at the table, Dudley on his highchair, cereal all over the walls, and a fridge.

You can see the kitchen door (east), Petunia, highchair (on which is pictures of Dudley), the kitchen table (on which are two pieces of toast and a coffee cup), the fridge (closed), suitcase (closed) and window here.

>look
kitchen
You look around the kitchen and see Petunia at the table, Dudley on his highchair, cereal all over the walls, and a fridge.

You can see the kitchen door (east), Petunia, highchair (on which is pictures of Dudley), the kitchen table (on which are two pieces of toast and a coffee cup), the fridge (closed), suitcase (closed) and window here.

>take suitcase
You take the suitcase from the kitchen.

>open sesame
Now all doors, vehicles, and containers are unlocked and open.

>cheats off
Now cheats are off.

>w
You can't go that way.

>e
Hall
You can see Dudley's fingermarks all over the walls here. He frequents the hall, conveniently placed as it is in between the television and the fridge. 

You can see the kitchen door (west), the cupboard door (north), the staircase (up), the front door (east), the living-room door (south) and the dining room door (southwest) here.

>e
Garden
You look around and see a driveway with the car on it, the garage where the car came out of, and the highway to the north. The rest of privet drive is to the east.

You can see the front door (west), Cat, garage (in which is light switch) and a car (empty) here.

>get in car
You get into the car.

>look
Garden (in the car)
You look around and see a driveway with the car on it, the garage where the car came out of, and the highway to the north. The rest of privet drive is to the east.

You can see the front door (west), Cat and garage (in which is light switch) here.

>n
As you back out of Privet Drive, you notice a tabby cat out of the corner of your eye. you also notice that the cat looks like it is reading a map. you look round again, but the map has gone. As you drive round the corner of the road, you notice the cat reading the sign - no, looking at the sign; cats can't read maps or signs.

highway (in the car)
As you sit in the usual traffic jam, you notice a lot of people around in robes. They seem to be surprised to see another person in robes on the road.  To the west is your work. To the east, a small bakery. And south, your garden.

>w
Grunnings Carpark (in the car)
You can see the highway to the east. There is a small shop on the other side.

You can see stairs (up), red car (empty), blue car (empty), rainbow car (empty), green car (empty) and elevator (in which is elevator button) here.

you see few cars in the Carpark today. Must be lots of people skipping work today. Slackers. It's people like them that keep our profits down...

>get out
You get out of the car.

Grunnings Carpark
You can see the highway to the east. There is a small shop on the other side.

You can see stairs (up), a car (empty), red car (empty), blue car (empty), rainbow car (empty), green car (empty) and elevator (in which is elevator button) here.

>u
corridor
Your office is north, and the elevator door is on the wall behind you.

You can see an office door (north) and stairs (down) here.

>n
Work office
As you enter your office, You can see your desk, with a phone on it. It seems someone has left you a document to read; You should also check your rolodex, in case anything important's come up.

You can see an office door (south), desk (on which are an office phone, an important customer service document, a rolodex, notepad, pen and two pound coins), a window, office chair and a filing cabinet here.

>sit down
You are now seated.

>look
Work office
You can see your desk, with a phone on it. It seems someone has left you a document to read; You should also check your rolodex, in case anything important's come up.

You can see an office door (south), desk (on which are an office phone, an important customer service document, a rolodex, notepad, pen and two pound coins), a window, office chair and a filing cabinet here.

>read rolodex
Tuesday

Work for today:

Answer two customer phone calls:
First call.
Second call.

After reading the rolodex, you look out the window to see an owl perched on the windowsill. How strange.

The phone rings.

"Hello?" says Mr. Mason on the other side of the line.

>hello
(addressing Mr. Mason)
"Hello Dursley. This is Mr. Mason."

"Can I order another 50 drills? the last ones where excellent."

>yes
"That's great. Now, what drills would you reccomend for its low price?"

You had that document in your suitcase... there should be a spare in the filing cabinet, if I can find the right drawer.

>i
You are carrying a suitcase. You are wearing wizards robes.

>open suitcase
That's already open.

>read papers
The latest drill models - The Bk 44 model T, The Qz  77, the T1000, and the HAL 6502.
The Bk 44 model T is reccomended for hard work and long lasting life.
The Qz 77 is reccomended for it's low, low price.
The HAL 6502 is reccomended for use with smaller screws and where finesse is needed.
The T1000 is reccomended for use with large bolts and large scale work.

* * *

The phone rings.

"Hello?" says Mr. Mason on the other side of the line.

I beg your pardon?

>hello
(addressing Mr. Mason)
"Hello Dursley. This is Mr. Mason."

* * *

"Can I order another 50 drills? the last ones where excellent."

I beg your pardon?

>yes
"That's great. Now, what drills would you reccomend for hardiness and ability to withstand impact?"

You had that document in your suitcase... there should be a spare in the filing cabinet, if I can find the right drawer.

>i
You are carrying a suitcase. You are wearing wizards robes.

* * *

>Orion
Your name for this pre-release test is "Orion".

>gonear garden
Garden
You look around and see a driveway with the car on it, the garage where the car came out of, and the highway to the north. The rest of privet drive is to the east.

You can see the front door (west), Cat, garage (closed) and a car (closed and empty) here.

>look at cart
You can't see any such thing.

>look at cat
The cat is sitting on the wall. It has markings around its eyes.

>take cat
You take Cat from Garden.

* * *

I beg your pardon?

Name:

I beg your pardon?

Name:

>test me
(Testing.)

Name: [1] orion
Your name for this pre-release test is "orion".

>[2] stats
dialyes/no is 0
lexicon current table is Table 1 - customer responses
the venture of customercall is incomplete
office phone is not Inuse
The venture of mrmason call is incomplete
mobilel is not inuse
last turn's action was looking
Bored is 0
The three digit number lock is 790
The tumblers are 000
the venture of work is incomplete
added score is 0
player's command: stats
Play success is 0
The location is Dursley's bedroom
Current region is Dursley's house
Credit is 0
venture of work is incomplete
Remembered product is yourself
Current interlocutor is nothing
tvonafterwork is 0
overlay is your former self

>[3] get up
You get out of bed.

Dursley's bedroom
You look around. There is a wardrobe, a bed, a bedside table with drawer attached, and a door to the north-west.

You can see the bedroom door (northwest), bedroom window (providing light), bed (empty), a clock, Wardrobe (closed) and bedside table here.

>[4] open drawer
You open bedside drawer, revealing a scrap of paper.

>[5] read paper

* * *

I beg your pardon?

Name:

>Orion
Your name for this pre-release test is "Orion".

* * *

>close stairs
You close Attic stairs.

>turn light off
It is now pitch dark in here!

>look
Darkness
It is pitch dark, and you can't see a thing.

>turn on light
You can't see any such thing.

>switch light on
You can't see any such thing.

>open stairs
You can't see any such thing.

>look
Darkness
It is pitch dark, and you can't see a thing.

* * *

>turn on light
You can't see any such thing.

>turn off light
You can't see any such thing.

>turn light on
You can't see any such thing.

>open stairs
You can't see any such thing.

>d
(first opening the door)
You pull on the panel, lowering a set of stairs to the ground that lead to the roof.

Landing
The landing is gleaming, scrubbed and well kept, courtesy of Petunia.

You can see Attic stairs (up), the staircase (down), the bedroom door (southeast), Dudley's second room's door (northeast) and Dudley's bedroom door (northwest) here.

* * *

>wear robes
You take off your pyjamas and put them away.

(first taking wizards robes)
You put on wizards robes.

>look in mirror
You look in the mirror and see your reflection.  In this outfit, the person in the mirror reminds you of your sister, Marge.

>look
Dursley's bedroom
You look around. There is a wardrobe, a bed, a bedside table with drawer attached, and a door to the north-west.

You can see the bedroom door (northwest), bedroom window (providing light), bed (empty), a clock, Wardrobe (in which are Pyjamas, a mirror, a suit, a muumuu and a tutu) and bedside table here.

* * *

I beg your pardon?

I beg your pardon?

>yes
"That's great. Now, what drills would you reccomend for work with large, tough, unweildy bolts?"

You had that document in your suitcase... there should be a spare in the filing cabinet, if I can find the right drawer.

>i
You are carrying a suitcase. You are wearing wizards robes.

* * *

>Orion
Your name for this pre-release test is "Orion".

>l
Dursley's bedroom (in bed)
You look around. There is a wardrobe, a bed, a bedside table with drawer attached, and a door to the north-west.

You can see the bedroom door (northwest), bedroom window (providing light), a clock, Wardrobe (closed) and bedside table here.

>get up
You get out of bed.

Dursley's bedroom
You look around. There is a wardrobe, a bed, a bedside table with drawer attached, and a door to the north-west.

You can see the bedroom door (northwest), bedroom window (providing light), bed (empty), a clock, Wardrobe (closed) and bedside table here.

>e
You can't go that way.

>ne
You can't go that way.

>w
You can't go that way.

>nw
Maybe you should wear something else before going.

* * *

>nw
Ok then. On your head be it.

(first opening the door)
Landing
The landing is gleaming, scrubbed and well kept, courtesy of Petunia.

You can see Dudley's second room's door (northeast), Dudley's bedroom door (northwest), a latched panel in the ceiling (up), the staircase (down) and the bedroom door (southeast) here.

>d
Hall
You can see Dudley's fingermarks all over the walls here. He frequents the hall, as it is in between the television and the fridge. There are rooms southwest, east, west, above, south, northeast and north of you.

You can see the living-room door (south), the dining room door (southwest), the front door (east), a white door (west), the cupboard door (north) and the staircase (up) here.

>w
"Are you ready for work dear?" Says Petunia.

* * *

>Orion
Your name for this pre-release test is "Orion".

>down
You'll have to say which compass direction to go in.

>down up
You'll have to get out of bed first.

>get up
You get out of bed.

Dursley's bedroom
You look around. There is a wardrobe, a bed, a bedside table with drawer attached, and a door to the north-west.

You can see the bedroom door (northwest), bedroom window (providing light), bed (empty), a clock, Wardrobe (closed) and bedside table here.

>down up
You can't go that way.

>d
You can't go that way.

>look
Dursley's bedroom
You look around. There is a wardrobe, a bed, a bedside table with drawer attached, and a door to the north-west.

You can see the bedroom door (northwest), bedroom window (providing light), bed (empty), a clock, Wardrobe (closed) and bedside table here.

>nw
Maybe you should wear something else before going.

* * *

>d
Hall
You can see Dudley's fingermarks all over the walls here. He frequents the hall, as it is in between the television and the fridge. There are rooms southwest, east, west, above, south, northeast and north of you.

You can see the living-room door (south), the dining room door (southwest), the front door (east), a white door (west), the cupboard door (north) and the staircase (up) here.

>s
(first opening the door)

living-room
You can see the living-room door (north), a door through to the dining room (west), a mantlepiece (on which are five photos), Piano (on which is sheet music), Stool, Armchair, Couch and Television here.

>turn on tv
You turn on the Television, but the only thing on is children's shows.

You switch Television on.

>read sheet music
You see nothing special about sheet music.

* * *

>Orion
Your name for this pre-release test is "Orion".

>purloin case
Which do you mean, suitcase or the foods display case?

>suitcase
[Purloined.]

>open suitcase
It seems to be locked.

* * *

>gonear garden
Garden
You look around and see a driveway with the car on it, the garage where the car came out of, and the highway to the north. The rest of privet drive is to the east.

You can see the front door (west), Cat, garage (closed) and a car (closed and empty) here.

>e
Privet Drive
your garden is to the west.

>w
Garden
You look around and see a driveway with the car on it, the garage where the car came out of, and the highway to the north. The rest of privet drive is to the east

You can see the front door (west), garage (closed) and a car (closed and empty) here.

* * *

>gonear garden
Garden
You look around and see a driveway with the car on it, the garage where the car came out of, and the highway to the north. The rest of privet drive is to the east.

You can see the front door (west), Cat, garage (closed) and a car (closed and empty) here.

>get in car
It seems to be locked.

Hmm... I think the car keys are in my suitcase.

You can't get into the closed car.

>open sesame
Now all doors, vehicles, and containers are unlocked and open.

>close car
You close the car.

>get in car
You get into the car.

* * *

>Orion
Your name for this pre-release test is "Orion".

>gonear office
Which do you mean, Work office, the office phone, office chair or the office door (north)?

>work office
Work office
As you enter your office, You can see your desk, with a phone on it. It seems someone has left you a document to read; You should also check your rolodex, in case anything important's come up.

You can see an office door (south), desk (on which are an office phone, an important customer service document, a rolodex, notepad, pen and two pound coins), a window, office chair and a filing cabinet here.

>read dex
Tuesday

Work for today:

Answer two customer phone calls:
First call.
Second call.

After reading the rolodex, you look out the window to see an owl perched on the windowsill. How strange.

The phone rings.

"Hello?" says Mr. Mason on the other side of the line.

* * *

>yes
"That's great. Now, what drills would you reccomend for its low price?"

You had that document in your suitcase... there should be a spare in the filing cabinet, if I can find the right drawer.

>open filing cabinet
as you open the drawer, you see some work that you filed yesterday.

>open filing cabinet
as you open the drawer, you see your Complaints section, which takes a whole drawer on it's own.

>open filing cabinet
as you open the drawer, you see your Complaints section, which takes a whole drawer on it's own.

>report error "when it says work you filed yesterday, it is unclear that this isn't what you are meant to look for"
Error noted.

>x fcdrawer
You see nothing special about Drawer.

Mr. Mason gets bored and hangs up. "If you remember, call me at 12856."

>undo
Work office
[Previous turn undone.]

>undo
Work office
[Previous turn undone.]

>x cabinet
as you open the drawer, you see a paper on which is written:
The latest drill models - The Bk 44 model T, The Qz  77, the T1000, and the HAL 6502.
The Bk 44 model T is reccomended for hard work and long lasting life.
The Qz 77 is reccomended for it's low, low price.
The HAL 6502 is reccomended for use with smaller screws and where finesse is needed.
The T1000 is reccomended for use with large bolts and large scale work.

>try the qz 77
"Thanks."

Mr. Mason continues. "You know, we've been having a lot of strange events today. Our building site is continually being swooped by owls, even during the day. And there's also some other strange things happening. Shooting stars and the likes."

>hgdas
"Hmmm... Well, goodbye Dursley."
You put down the office phone, cutting the connection.

>look rolodex
Tuesday

Work for today:

Answer two customer phone calls:
First call.
Second call: achieved

>report error "if you answer Mr Mason's call first it still says it is the second call"
Error noted.

>read ics
To do your job properly:

Unless the person is Mr Mason, or another experienced customer:
First step:
Answer any questions from customer, and respond to any niceties.
Next Step:
tell the customer to "call 8953". 
Next step:
Tell them to "ask for a T1000", our priciest model. (Don't tell them about it being pricey)

As you go about looking at the document, the phone rings. How convenient.
You pick up the phone.

Hello? Says the voice on the other end of the line. 
"Hello. How are you?" says the customer.

>hello
(addressing the Customer)
"Hello. How are you?"

>I'm good
That seems like a rather pointless, if typical, thing for you to say.

>good
(morning the Customer)
"Now, how do I make an order?"

>call 8953
(on the office phone)

"Ok. And then what?" Asks the customer.

* * *

>then ask for a t1000
"Ok, Thanks. I'll do that."

you put down the office phone, cutting the connection.

Your boss walks into the office. "Good Job", he says. "I see you've made a few good sales. go, take a break; have some lunch.".

>read dex
Tuesday

Work for today:

Answer two customer phone calls:
First call: achieved
Second call: achieved
You can go for lunch!

>report error The answers you can provide customers is a bit limited
Error noted.

* * *

>Orion
Your name for this pre-release test is "Orion".

>gonear carpark
Grunnings Carpark
You can see the highway to the east. There is a small shop on the other side.

You can see stairs (up), red car (closed), blue car (closed), rainbow car (closed), green car (closed) and elevator (in which is elevator button) here.

>u
corridor
You can see an office door (north), stairs (down) and elevator door (empty) here.

>open elevator door
The elevator seems to be being used at the moment. There are stairs, you know. do you know what they are?

>look elevator
The elevator seems to be being used at the moment. There are stairs, you know. do you know what they are?

* * *

>Orion
Your name for this pre-release test is "Orion".

>gonear street
street
The Grunnings building looms large to the west of you, on the other side of the highway.

You can see a shop door (east) here.

* * *

>Orion
Your name for this pre-release test is "Orion".

>down
(Pyjamas)
You'll have to get out of bed first.

>down up
You'll have to get out of bed first.

* * *

>nw
Ok then. On your head be it.

(first opening the door)
Landing
The landing is gleaming, scrubbed and well kept, courtesy of Petunia.

You can see Dudley's second room's door (northeast), Dudley's bedroom door (northwest), a latched panel in the ceiling (up), the staircase (down) and the bedroom door (southeast) here.

>d
Hall
You can see Dudley's fingermarks all over the walls here. He frequents the hall, conveniently placed as it is in between the television and the fridge. 

You can see the living-room door (south), the dining room door (southwest), the front door (east), a white door (west), the cupboard door (north) and the staircase (up) here.

>s
(first opening the door)

living-room
You can see the living-room door (north), a door through to the dining room (west), a mantlepiece (on which are five photos), Piano (on which is sheet music), Stool, Armchair, Couch and Television here.

* * *

>turn on tv
You turn on the Television, but the only thing on is children's shows.

You switch Television on.

>read sheet music
A selection of old songs is here to be played; Some music from the TV show Buffy, some Rock and roll, and a cauldron full of hot, strong love.

* * *

>gonear garden
Garden
You look around and see a driveway with the car on it, the garage where the car came out of, and the highway to the north. The rest of privet drive is to the east.

You can see the front door (west), Cat, garage (closed) and a car (closed and empty) here.

>get in car
It seems to be locked.

Hmm... I think the car keys are in my suitcase.
(first opening car)
You can't get into the closed car.

>open sesame
Now all doors, vehicles, and containers are unlocked and open.

* * *

>close car
You close the car.

>get in car
(first opening car)
You get into the car.

* * *

>wear robes
You take off your pyjamas and put them away.

(first taking wizards robes)
You put on wizards robes.

>look in mirror
You look in the mirror and see your reflection. That outfit looks wonderful!

>look
Dursley's bedroom
You look around. There is a wardrobe, a bed, a bedside table with drawer attached, and a door to the north-west.

You can see the bedroom door (northwest), bedroom window (providing light), bed (empty), a clock, Wardrobe (in which are Pyjamas, a mirror, a suit, a muumuu and a tutu) and bedside table here.

* * *

I beg your pardon?

>yes
"That's great. Now, what drills would you reccomend for working with small, fiddly screws?"
You had that document in your suitcase... there should be a spare in the filing cabinet, if I can find the right drawer.

>i
You are carrying a suitcase. You are wearing wizards robes.

* * *

>read papers
The latest drill models - The Bk 44 model T, The Qz  77, the T1000, and the HAL 6502.
The Bk 44 model T is reccomended for hard work and long lasting life.
The Qz 77 is reccomended for it's low, low price.
The HAL 6502 is reccomended for use with smaller screws and where finesse is needed.
The T1000 is reccomended for use with large bolts and large scale work.

>try the hal 6502
"Thanks."

Mr. Mason continues. "You know, we've been having a lot of strange events today. Our building site is continually being swooped by owls, even during the day. And there's also some other strange things happening. Shooting stars and the likes."

>is there?
"Hmmm... Well, goodbye Dursley."
You put down the office phone, cutting the connection.

>look
Work office
You can see your desk, with a phone on it. It seems someone has left you a document to read; You should also check your rolodex, in case anything important's come up.

You can see an office door (south), desk (on which are an office phone, an important customer service document, a rolodex, notepad, pen and two pound coins), a window, office chair and a filing cabinet here.

>read rolodex
Tuesday

Work for today:

Answer two customer phone calls:
First call.
Second call: achieved

>read ics
To do your job properly:

Unless the person is Mr Mason, or another experienced customer:
First step:
Answer any questions from customer, and respond to any niceties.
Next Step:
tell the customer to "call 8953". 
Next step:
Tell them to "ask for a T1000", our priciest model. (Don't tell them about it being pricey)

* * *

As you go about looking at the document, the phone rings. How convenient.
You pick up the phone.

Hello? Says the voice on the other end of the line. 
"Hello. How are you?" says the customer.

>good
(morning the Customer)
"Hello. How are you?"

>good
(morning the Customer)
"Great. Now, how do I order the drill?"

>try calling 8953
(on the office phone)

"Ok. And then what?" Asks the customer.

>then ask for a t1000
"Ok, Thanks. I'll do that."

you put down the office phone, cutting the connection.

Your boss walks into the office. "Good Job", he says. "I see you've made a few good sales. go, take a break; have some lunch. There's a good bakery across the road; it opened recently".

>s
(first standing up)

corridor
Your office is north, and the elevator door is on the wall behind you.

You can see an office door (north) and stairs (down) here.

>d
Grunnings Carpark
You can see the highway to the east. There is a small shop on the other side.

You can see stairs (up), a car (empty), red car (empty), blue car (empty), rainbow car (empty), green car (empty) and elevator (in which is elevator button) here.

>e
street
The Grunnings building looms large to the west of you, on the other side of the highway.

You can see a shop door (east) here.

>e
"Good morning! How may i help you, sir?" asks the shop attendant.

>w
street
The Grunnings building looms large to the west of you, on the other side of the highway.

You can see a shop door (east) here.

>listen
"The Potters, that's right, that's what I heard -"
"-yes, their son, Harry-"
Potter? Petunia's sister's husband? I need to get back to the office and call petunia.

>undp
That's not a verb I recognise.

>undo
street
[Previous turn undone.]

>undo
street
[Previous turn undone.]

>undo
The Baker's
[Previous turn undone.]

>rules
Rules tracing now switched on. Type "rules off" to switch it off again, or "rules all" to include even rules which do not apply.

* * *

>showme baker's
[Rule "after reading a command when the venture of work is half-complete" applies.]
[Rule "after reading a command during uncle vernon's scene" applies.]
[Rule "after reading a command during work" applies.]
[Rule "after reading a command during uncle vernon's scene" applies.]
[Rule "after reading a command during uncle vernon's scene" applies.]
[Rule "after reading a command during uncle vernon's scene" applies.]
[Rule "after reading a command during uncle vernon's scene" applies.]
There seems to be no such object anywhere in the model world.

>rules off
[Rule "after reading a command when the venture of work is half-complete" applies.]
[Rule "after reading a command during uncle vernon's scene" applies.]
[Rule "after reading a command during work" applies.]
[Rule "after reading a command during uncle vernon's scene" applies.]
[Rule "after reading a command during uncle vernon's scene" applies.]
[Rule "after reading a command during uncle vernon's scene" applies.]
[Rule "after reading a command during uncle vernon's scene" applies.]
Rules tracing now switched off. Type "rules" to switch it on again.

>locate baker's
That noun did not make sense in this context.

>room stats
You have been to 10 out of 21 rooms.

Darkness is not visited
Dursley's bedroom is Visited
Landing is Visited
Hall is Visited
Toilet is not visited
attic is not visited
cupboard is not visited
kitchen is Visited
Garden is Visited
highway is Visited
Grunnings Carpark is Visited
corridor is Visited
Work office is Visited
street is Visited
The Baker's is not visited
Dining room is not visited
living-room is not visited
Dudley's bedroom is not visited
Dudley's second room is not visited
Bathroom is not visited
Privet Drive is not visited

>e
"Good morning! How may i help you, sir?" asks the shop attendant.

>look
The Baker's
You can see a shop door (west), a Shop attendant and a foods display case (in which are a doughnut, a bun, a breadstick and two small rolls) here.

>w
As you stroll out of the shop, you notice another group of robed people standing further down the road. I wonder what they could be talking about?

street
The Grunnings building looms large to the west of you, on the other side of the highway.

You can see a shop door (east) here.

* * *

>gonear street
street
The Grunnings building looms large to the west of you, on the other side of the highway.

You can see a shop door (east) here.

>e
(first opening the door)
"Good morning! How may i help you, sir?" asks the shop attendant.

>w
As you stroll out of the shop, you notice another group of robed people standing further down the road. I wonder what they could be talking about?

street
The Grunnings building looms large to the west of you, on the other side of the highway.

You can see a shop door (east) here.

>listen
You listen intently. However, it seems like your efforts are pointless. There's nothing you can hear.

* * *

>take cat
You take Cat from Garden.

>cheats off
Now cheats are off.

>drop at
You can't see any such thing.

>drop cat
Dropped.

>take cat
I don't suppose Cat would care for that.

* * *

>get in car
(first opening car)
You get into the car.

>get out
You get out of the car.

Garden
You look around and see a driveway with the car on it, the garage where the car came out of, and the highway to the north. The rest of privet drive is to the east.

You can see the front door (west), garage (in which is light switch) and a car (empty) here.

>enter garage
You get into garage.

In garage you can see light switch.

>turn on light
You switch light switch on.

>close door
You close the front door.

>close garage
You close garage.

as you close the garage, a secret hole opens in the floor, revealing a Ferrari, which is slowly brought out to ground level.

>open ferrari
(Ferrari Enzo)
That's not something you can open.

you can see your ferrari taking pride of place in your garage.

>open ferrari door
That's already open.

you can see your ferrari taking pride of place in your garage.

>get in ferrari
(Ferrari Enzo)
You get into Ferrari Enzo.

In Ferrari Enzo you can see start button.

>look ferrari
(Ferrari Enzo)
In Ferrari Enzo is start button.

>press button
You switch start button on.

You need to open the garage before you can leave.

>wait
Time passes.

>open garage
You open garage.

Garden (in Ferrari Enzo)
You look around and see a driveway with the car on it, the garage where the car came out of, and the highway to the north. The rest of privet drive is to the east.

You can see the front door (west), garage (in which is light switch) and a car (empty) here.

In Ferrari Enzo you can see start button.

* * *

>Orion
Your name for this pre-release test is "Orion".

>gonear garden
Garden
You look around and see a driveway with the car on it, the garage where the car came out of, and the highway to the north. The rest of privet drive is to the east.

You can see the front door (west), garage (closed) and a car (closed and empty) here.

>get in car
It seems to be locked.

Hmm... I think the car keys are in my suitcase.
(first opening car)
You can't get into the closed car.

* * *

>close garage
You close garage.

as you close the garage, a secret hole opens in the floor, revealing a Ferrari, which is slowly brought out to ground level.

>open ferrari
(Ferrari Enzo)
That's already open.

you can see your ferrari taking pride of place in your garage.

>open ferrari door
That's already open.

you can see your ferrari taking pride of place in your garage.

* * *

>get in ferrari
(Ferrari Enzo)
You get into Ferrari Enzo.

In Ferrari Enzo you can see start button.

>look ferrari
(Ferrari Enzo)
An immaculately kept Enzo, with carbon fibre everything and  an engine with more capacity than your stomach.

In Ferrari Enzo is start button.

>press button
You switch start button on.

You need to open the garage before you can leave.

* * *

>wait
Time passes.

>open garage
You open garage.

You open the garage with a remote and go to the garden.

Garden (in Ferrari Enzo)
You look around and see a driveway with the car on it, the garage where the car came out of, and the highway to the north. The rest of privet drive is to the east.

You can see the front door (west), garage (in which is light switch) and a car (empty) here.

In Ferrari Enzo you can see start button.

>n
highway (in Ferrari Enzo)
As you sit in the usual morning traffic jam, you notice how there seem to be a lot of strangely dressed people about. people in cloaks. To the west is your work. To the east, a small bakery. And south, your garden.

In Ferrari Enzo you can see start button.

* * *

>look
attic
As you enter the attic, you see pictures of Dudley all over the walls.

You can see Attic stairs (down), Dudley's pictures, dusty box (closed), Petunia's diary and light (providing light) here.

>turn off light
You switch light off.

>actions
Actions listing on.

>turn on light
[switching on light]
You switch light on.
[switching on light - succeeded]

* * *

>suitcase
[Purloined.]

>open suitcase
Enter the combination lock code:

>999
That doesn't seem right.

>look
Dursley's bedroom (in bed)
You look around. There is a wardrobe, a bed, a bedside table with drawer attached, and a door to the north-west.

You can see the bedroom door (northwest), bedroom window (providing light), a clock, Wardrobe (closed) and bedside table here.

>nw
Maybe you should wear something else before going.

* * *

>nw
Are you sure? Do you want to go out in your pyjamas?

>nw
Ok then. On your head be it.

You'll have to get out of bed first.

>get up
You get out of bed.

Dursley's bedroom
You look around. There is a wardrobe, a bed, a bedside table with drawer attached, and a door to the north-west.

You can see the bedroom door (northwest), bedroom window (providing light), bed (empty), a clock, Wardrobe (closed) and bedside table here.

>nw
Ok then. On your head be it.

(first opening the door)
Landing
The landing is gleaming, scrubbed and well kept, courtesy of Petunia.

You can see Dudley's second room's door (northeast), Dudley's bedroom door (northwest), a latched panel in the ceiling (up), the staircase (down) and the bedroom door (southeast) here.

>se
Dursley's bedroom
You look around. There is a wardrobe, a bed, a bedside table with drawer attached, and a door to the north-west.

You can see the bedroom door (northwest), bedroom window (providing light), bed (empty), a clock, Wardrobe (closed) and bedside table here.

>nw
Ok then. On your head be it.

Landing
The landing is gleaming, scrubbed and well kept, courtesy of Petunia.

You can see the bedroom door (southeast), Dudley's second room's door (northeast), Dudley's bedroom door (northwest), a latched panel in the ceiling (up) and the staircase (down) here.

>look
Landing
The landing is gleaming, scrubbed and well kept, courtesy of Petunia.

You can see the bedroom door (southeast), Dudley's second room's door (northeast), Dudley's bedroom door (northwest), a latched panel in the ceiling (up) and the staircase (down) here.

>d
Hall
You can see Dudley's fingermarks all over the walls here. He frequents the hall, conveniently placed as it is in between the television and the fridge. 

You can see the living-room door (south), the dining room door (southwest), the front door (east), a white door (west), the cupboard door (north) and the staircase (up) here.

>e
(first opening the door)

Garden
You look around and see a driveway with the car on it, the garage where the car came out of, and the highway to the north.

You can see the front door (west), garage (closed) and a car (closed and empty) here.

* * *

>gonear carpark
Grunnings Carpark
You can see the highway to the east. There is a small shop on the other side.

You can see stairs (up), red car (closed), blue car (closed), rainbow car (closed), green car (closed) and elevator (in which is elevator button) here.

>u
corridor
Your office is north, and the elevator door is on the wall behind you.

You can see an office door (north) and stairs (down) here.

>open elevator door
The elevator seems to be being used at the moment. There are stairs, you know. do you know what they are?

* * *

>Orion
Your name for this pre-release test is "Orion".

>open table
You open bedside drawer, revealing a scrap of paper.

>get up
You get out of bed.

Dursley's bedroom
You look around. There is a wardrobe, a bed, a bedside table with drawer attached, and a door to the north-west.

You can see the bedroom door (northwest), bedroom window (providing light), bed (empty), a clock, Wardrobe (closed) and bedside table here.

>open wardrobe
You open Wardrobe, revealing a mirror, wizards robes, a suit, a muumuu and a tutu.

>wear tutu
You take off your pyjamas.

(first taking the tutu)
You put on the tutu.

* * *

>look
attic
As you enter the attic, you see pictures of Dudley all over the walls.

You can see Attic stairs (down), Dudley's pictures, dusty box (closed), Petunia's diary and light (providing light) here.

>turn off light
That's already off.

* * *

[Sound effect number 6 here.]
Harry Potter and the Philosopher's stone
Influenced by "Harry Potter and the Philosopher's stone" by J.K. Rowling. by Orion Zymaris
Release 1 / Serial number 131217 / Inform 7 build 6G60 (I6/v6.32 lib 6/12N) SD

Welcome to An Interactive Fiction version of Harry Potter.
                (If you ever need help, type help.)

When Mr and Mrs Dursley woke up on the dull, grey Tuesday our story starts, there was nothing about the cloudy sky outside to suggest that strange and mysterious things would soon be happening all over the country.

Mrs Dursley goes downstairs and says "You should get ready for work dear!"
Harry Potter and the Philosopher's stone
Influenced by "Harry Potter and the Philosopher's stone" by J.K. Rowling. by Orion Zymaris
Release 1 / Serial number 131217 / Inform 7 build 6G60 (I6/v6.32 lib 6/12N) SD

Dursley's bedroom (in bed)
You look around. There is a wardrobe, a bed, a bedside table with drawer attached, and a door to the north-west.

You can see the bedroom door (northwest), bedroom window (providing light), a clock, Wardrobe (closed) and bedside table here.

Name:

I beg your pardon?

Name:

* * *

>\\
[Sound effect number 4 here.]
Welcome to An Interactive Fiction version of Harry Potter.
                (If you ever need help, type help.)

Mr Dursley was the director of a firm called Grunnings, which made drills. He was a big, beefy man with hardly any neck, although he did have a very large moustache. Mrs Dursley was thin and blonde and had nearly twice the usual amount of neck, which came in very useful as she spent so much of her time craning over garden fences, spying on the neighbours. The Dursleys had a small son called Dudley and in their opinion there was no finer boy anywhere.

[Sound effect number 5 here.]
Welcome to An Interactive Fiction version of Harry Potter.
                (If you ever need help, type help.)

The Dursleys had everything they wanted, but they also had a secret, and their greatest fear was that somebody would discover it. They didn't think they could bear it if anyone found out about the Potters. Mrs Potter was Mrs Dursley's sister, but they hadn't met for several years; in fact, Mrs Dursley pretended she didn't have a sister, because her sister and her good-for-nothing husband were as unDursleyish as it was possible to be. The Dursleys shuddered to think what the neighbours would say if the Potters arrived in the street. The Dursleys knew that the Potters had a small son too, but they had never seen him. This boy was another good reason for keeping the Potters away; they didn't want Dudley mixing with a child like that.

[Sound effect number 6 here.]
Harry Potter and the Philosopher's stone
Influenced by "Harry Potter and the Philosopher's stone" by J.K. Rowling. by Orion Zymaris
Release 1 / Serial number 131217 / Inform 7 build 6G60 (I6/v6.32 lib 6/12N) SD

Welcome to An Interactive Fiction version of Harry Potter.
                (If you ever need help, type help.)

When Mr and Mrs Dursley woke up on the dull, grey Tuesday our story starts, there was nothing about the cloudy sky outside to suggest that strange and mysterious things would soon be happening all over the country.

Mrs Dursley goes downstairs and says "You should get ready for work dear!"
Harry Potter and the Philosopher's stone
Influenced by "Harry Potter and the Philosopher's stone" by J.K. Rowling. by Orion Zymaris
Release 1 / Serial number 131217 / Inform 7 build 6G60 (I6/v6.32 lib 6/12N) SD

Dursley's bedroom (in bed)
You look around. There is a wardrobe, a bed, a bedside table with drawer attached, and a door to the north-west.

You can see the bedroom door (northwest), bedroom window (providing light), a clock, Wardrobe (closed) and bedside table here.

Name:

* * *

Still,you find it difficult to focus for the rest of the day. Why where the oddly dressed people talking about your sister's son?

Even though you have your chance to yell at a few people, your heart isn't in it.
When the boss comes in to tell you that you can go home, you barely notice.

Work office
You can see your desk, with a phone on it. 

You can see an office door (south), desk (on which are an office phone, an important customer service document, a rolodex and notepad), a window, office chair and a filing cabinet here.

>[90] wait
Time passes.

>[91] s

corridor
Your office is north, and the elevator door is on the wall behind you.

You can see an office door (north) and stairs (down) here.

>[92] go down
As you're a bit distracted, you don't see where you are going, and you bump into someone. 
"Sorry", you say gruffly, before realising that this small man is wearing a violet cloak.

"Don't be sorry, my dear sir, for nothing could upset me today!
Rejoice, for You-Know-Who has gone at last!
Even Muggles such as yourself should be celebrating, this happy, happy day!"

>[93] mount broom
You mount broom.

>[94] e

highway (on broom)
The people in cloaks still seem to be around, and in large numbers.

 To the west is your work. To the east, a small bakery. And south, your garden.

>[95] s

Garden (on broom)
You notice the cat from this morning sitting on the garden wall. Despite your attempts to shoo it away, it is still sitting there, looking sternly at you.

You can see the front door (west), Cat, garage (closed) and a car (closed and empty) here.

>[96] get off broom
You dismount broom.

Garden
You notice the cat from this morning sitting on the garden wall. Despite your attempts to shoo it away, it is still sitting there, looking sternly at you.

You can see the front door (west), Cat, garage (closed) and a car (closed and empty) here.

>[97] w
After a long day, you feel like putting your feet up and watching TV. You've earned it.

Hall
You can see Dudley's fingermarks all over the walls here. He frequents the hall, conveniently placed as it is in between the television and the fridge. 

You can see the living-room door (south), the dining room door (southwest), the front door (east), a white door (west), the cupboard door (north) and the staircase (up) here.

>[98] s
(first opening the door)

living-room
You can see the living-room door (north), a door through to the dining room (west), a mantlepiece (on which are five photos), Piano (on which is sheet music), Stool, Armchair, Couch and Television here.

>[99] sit down
That's not something you can open.

(first opening Armchair)
You are now seated on Armchair.

>[100] turn on tv
As you switch in the television, you are greeted with the sight of the last few minutes of the evening news.

"And finally, bird-watchers everywhere have reported that the nation's owls have been behaving very unusually today.
Although owls normally hunt at night and are hardly ever seen in daylight, there have been hundreds of sightings of these birds flying in every direction since sunrise.

Experts are unable to explain why the owls have suddenly changed their sleeping pattern. Most mysterious.

And now, over to Jim McGuffin with the weather. Going to be any more showers of owls tonight, Jim?".

"Well, Ted, I don't know about that, but it's not only the owls that have been acting oddly today.
Viewers as far apart as Kent, Yorkshire, and Dundee have been phoning in to tell me that instead of the rain I promised yesterday, they've had a downpour of shooting stars!
Perhaps people have been celebrating Bonfire Night early - it's not untill next week, folks! But I can promise a wet night tonight.

As you sit there thinking about your day, Petunia comes into the room, carrying a tray with 2 cups of tea."Here's your tea, Vernon".

>[101] wait
Time passes.

>[102] think
What a good idea.

>[103] drink tea
You gulp down some tea.
"Er - Petunia, dear - you haven't heard from your sister lately, have you?"

"No. Why?" Says Petunia, rather sharply.

You gulp down some tea.

"Funny stuff on the news. Owls... shooting stars...

And there were a lot of funny-looking people in town today..."

"So?" Snapped Petunia.

"Well, I just thought... maybe... it was something to do with... you know... her lot."

You gulp down some Tea.

"Their son - he'd be about Dudley's age now, wouldn't he?"

"I Suppose so."

"What's his name again? Howard, isn't it?"

"Harry. Nasty, common name, if you ask me."

"Oh, yes. Yes, I quite agree..."

Without another word, you and Petunia both go upstairs to bed.

Dursley's bedroom
You look around. There is a wardrobe, a bed, a bedside table with drawer attached, and a door to the north-west.

You can see the bedroom door (northwest), bedroom window (providing light), bed (empty), a clock, Wardrobe (in which are Pyjamas, a mirror, wizards robes, a suit and a tutu) and bedside table here.

>[104] look window
As you look out the window, you see the cat from this morning, as well as a tall, thin man, who silently walks from the corner of the street. He holds up a small object, and suddenly, all the lamps in the street go out.

Today's been a bit tiring. You should get to bed.

>[105] get in bed
As you climb into bed, you hear slight mutterings from outside, and the sound of a motorbike.

    *** This is the end of chapter 1 ***

In that game you scored 0 out of a possible 0, in 85 turns.

Would you like to RESTART, RESTORE a saved game, QUIT or UNDO the last command?