Scooby doo
An Interactive Fiction by Orion Z
Release 1 / Serial number 130408 / Inform 7 build 6G60 (I6/v6.32 lib 6/12N) SD

Road (in Mystery machine)
In Mystery machine you can see Velma Dinkley, Shaggy Rogers, Fred Jones and Daphne Blake.

>eat
(the Ghost)
As you try eating the Ghost, all of the copies.

>i
You are carrying:
  a Ghost

>eat the ghost
He's plainly inedible.

>eat ghost
He's plainly inedible.

>drop ghost
Dropped.

>look
Mystery room
You can see twenty Ghosts here.

>take all
There are none at all available!

>take ghost
I don't suppose the Ghost would care for that.

>look
Mystery room
You can see twenty Ghosts here.

>look
Mystery room
You can see twenty Ghosts here.

>eat
(the Ghost)
He's plainly inedible.

>n
You can't go that way.

>w
You can't go that way.

>take all
There are none at all available!

* * *

Scooby doo
An Interactive Fiction by Orion Z
Release 1 / Serial number 130408 / Inform 7 build 6G60 (I6/v6.32 lib 6/12N) SD

Road (in Mystery machine)
In Mystery machine you can see Velma Dinkley, Shaggy Rogers, Fred Jones and Daphne Blake.

>look
Road (in Mystery machine)
In Mystery machine you can see Velma Dinkley, Shaggy Rogers, Fred Jones and Daphne Blake.

>take all
There are none at all available!

>eat
(the Ghost)
As you try eating the Ghost, all of the copies.

>eat
(the Ghost)
He's plainly inedible.

>drop
(the Ghost)
Dropped.

* * *

>look
Road (in Mystery machine)
In Mystery machine you can see Velma Dinkley, Shaggy Rogers, Fred Jones and Daphne Blake.

>hello
(addressing Velma Dinkley)
That would be a terrible idea.

You say hello to Velma Dinkley.

>hello
You are already talking to Velma Dinkley.

>hello shaggy
I only understood you as far as wanting to hello.

>shaggy, hello
That would be a terrible idea.

You say hello to Shaggy Rogers.

* * *

Scooby doo
An Interactive Fiction by Orion Z
Release 1 / Serial number 130408 / Inform 7 build 6G60 (I6/v6.32 lib 6/12N) SD

Road (in Mystery machine)
In Mystery machine you can see Velma Dinkley, Shaggy Rogers, Fred Jones and Daphne Blake.

>hello
(addressing Velma Dinkley)
""Are you well?" Actually, we have a mystery to solve now. do you want to go north?

>hello
You are already talking to Velma Dinkley.

>bye
"Bye!" says Velma Dinkley
You say goodbye to Velma Dinkley.

* * *

>hello
(addressing Velma Dinkley)
""Are you well?" Actually, we have a mystery to solve now. do you want to go north?

>actions
Actions listing on.

>goodbye
[leavetaking]
[(1) saying goodbye to Daphne Blake]
"Bye!" says Daphne Blake
You say goodbye to Daphne Blake.

[(1) saying goodbye to Daphne Blake - succeeded]

[leavetaking - succeeded]

>actions of
I only understood you as far as wanting to actions.

>actions off
Actions listing off.

>hello
(addressing Daphne Blake)
""Hello!"  Says Daphne Blake. 
You say hello to Daphne Blake.

>hello
You are already talking to Daphne Blake.

>bye
"Bye!" says Daphne Blake
You say goodbye to Daphne Blake.

>hello
(addressing Fred Jones)
"How are you?" asks Fred Jones. Actually, we have a mystery to solve now. do you want to go north?

You say hello to Fred Jones.

>n
"Bye!" says Fred Jones
Haunted house (in Mystery machine)
In Mystery machine you can see Velma Dinkley, Shaggy Rogers, Fred Jones and Daphne Blake.

* * *

>hello
(addressing Velma Dinkley)
""Are you well?" Actually, we have a mystery to solve now. do you want to go north?

>n
"Bye!" says Velma Dinkley.

yard (in Mystery machine)
As you pull up to the house, you see ghosts roaming around the yard. however, they seem harmless enough. to the north is a house.

In Mystery machine you can see Velma Dinkley, Shaggy Rogers, Fred Jones and Daphne Blake.

>get out
You get out of Mystery machine.

yard
As you pull up to the house, you see ghosts roaming around the yard. however, they seem harmless enough. to the north is a house.

You can see Mystery machine (in which are Velma Dinkley, Shaggy Rogers, Fred Jones and Daphne Blake) here.

>n
House
A typical haunted house. you look around to the sight of ghosts everywhere. there is a cupboard to your right.

You can see cupboard (closed) here.

>open cupboard
You open cupboard, revealing a lever.

>pull lever
As you pull on the lever, a secret panel opens in the wall of the cupboard.

>look
House
A typical haunted house. you look around to the sight of ghosts everywhere. there is a cupboard to your right.

You can see cupboard (in which is a lever) here.

* * *

>hello
(addressing Velma Dinkley)
""Are you well?" Actually, we have a mystery to solve now. do you want to go north?

>look
Road (in Mystery machine)
In Mystery machine you can see Velma Dinkley, Shaggy Rogers, Fred Jones and Daphne Blake.

>e
You can't go that way.

>s
You can't go that way.

>n
"Bye!" says Shaggy Rogers.

yard (in Mystery machine)
As you pull up to the house, you see ghosts roaming around the yard. however, they seem harmless enough. to the north is a house.

In Mystery machine you can see Velma Dinkley, Shaggy Rogers, Fred Jones and Daphne Blake.

>get out
You get out of Mystery machine.

yard
As you pull up to the house, you see ghosts roaming around the yard. however, they seem harmless enough. to the north is a house.

You can see Mystery machine (in which are Velma Dinkley, Shaggy Rogers, Fred Jones and Daphne Blake) here.

>n
House
A typical haunted house. you look around to the sight of ghosts everywhere. there is a cupboard and two doors here.

>s
yard
As you pull up to the house, you see ghosts roaming around the yard. however, they seem harmless enough. to the north is a house.

You can see Mystery machine (in which are Velma Dinkley, Shaggy Rogers, Fred Jones and Daphne Blake) here.

* * *

>hello
(addressing Velma Dinkley)
""Are you well?" Actually, we have a mystery to solve now. do you want to go north?

>hello daphne
I only understood you as far as wanting to hello.

>hello
(addressing Shaggy Rogers)
"How are you?" asks Shaggy Rogers.

>hello velma
I only understood you as far as wanting to hello.

>velma, hello
""Hello!"  Says Velma Dinkley. Actually, we have a mystery to solve now. do you want to go north?

>n
yard (in Mystery machine)
As you pull up to the house, you see ghosts roaming around the yard. however, they seem harmless enough. to the north is a house.

In Mystery machine you can see Velma Dinkley, Shaggy Rogers, Fred Jones and Daphne Blake.

>get out
You get out of Mystery machine.

yard
As you pull up to the house, you see ghosts roaming around the yard. however, they seem harmless enough. to the north is a house.

You can see Mystery machine (in which are Velma Dinkley, Shaggy Rogers, Fred Jones and Daphne Blake) here.

* * *

Scooby doo
An Interactive Fiction by Orion Z
Release 1 / Serial number 130408 / Inform 7 build 6G60 (I6/v6.32 lib 6/12N) SD

Road (in Mystery machine)
In Mystery machine you can see Velma Dinkley, Shaggy Rogers, Fred Jones and Daphne Blake.

>n
yard (in Mystery machine)
As you pull up to the house, you see ghosts roaming around the yard. however, they seem harmless enough. to the north is a house.

In Mystery machine you can see Velma Dinkley, Shaggy Rogers, Fred Jones and Daphne Blake.

* * *

>get out
You get out of Mystery machine.

yard
As you pull up to the house, you see ghosts roaming around the yard. however, they seem harmless enough. to the north is a house.

You can see Mystery machine (in which are Velma Dinkley, Shaggy Rogers, Fred Jones and Daphne Blake) here.

>n
House
A typical haunted house. you look around to the sight of ghosts everywhere. there is a cupboard and two doors here.

You can see cupboard (closed) here.

>e
Corridor

>n
Main room
You can see an organ here.

>play organ
You press one of the keys, and a  burst of sound emenates from the organ's pipes. Quickly, you remove your hand and back away.

>play organ
You shouldn't do that again.

* * *

>n
yard (in Mystery machine)
As you pull up to the house, you see ghosts roaming around the yard. however, they seem harmless enough. to the north is a house.

In Mystery machine you can see Velma Dinkley, Shaggy Rogers, Fred Jones and Daphne Blake.

>n
House (in Mystery machine)
A typical haunted house. you look around to the sight of ghosts everywhere. there is a cupboard and two doors here.

In Mystery machine you can see Velma Dinkley, Shaggy Rogers, Fred Jones and Daphne Blake.

>n
cupboard (in Mystery machine)
You can see a lever here.

In Mystery machine you can see Velma Dinkley, Shaggy Rogers, Fred Jones and Daphne Blake.

>pull lever
As you pull on the lever, a secret panel opens in the wall of the cupboard.

>look
cupboard (in Mystery machine)
Inside the cupboard, there is an open panel to your north.

You can see a lever here.

In Mystery machine you can see Velma Dinkley, Shaggy Rogers, Fred Jones and Daphne Blake.

>get out
You get out of Mystery machine.

cupboard
You can see Mystery machine (in which are Velma Dinkley, Shaggy Rogers, Fred Jones and Daphne Blake) and a lever here.

>look
cupboard
You can see Mystery machine (in which are Velma Dinkley, Shaggy Rogers, Fred Jones and Daphne Blake) and a lever here.

* * *

>look
cupboard (in Mystery machine)
Inside the cupboard, there is an open panel to your north.

You can see a lever here.

In Mystery machine you can see Velma Dinkley, Shaggy Rogers, Fred Jones and Daphne Blake.

>close panel
You can't see any such thing.

>n
secret room (in Mystery machine)
You can see panel here.

In Mystery machine you can see Velma Dinkley, Shaggy Rogers, Fred Jones and Daphne Blake.

>s
cupboard (in Mystery machine)
Inside the cupboard, there is an open panel to your north.

You can see a lever here.

In Mystery machine you can see Velma Dinkley, Shaggy Rogers, Fred Jones and Daphne Blake.

>n
secret room (in Mystery machine)
You can see panel here.

In Mystery machine you can see Velma Dinkley, Shaggy Rogers, Fred Jones and Daphne Blake.

>look
secret room (in Mystery machine)
You can see panel here.

In Mystery machine you can see Velma Dinkley, Shaggy Rogers, Fred Jones and Daphne Blake.

>close panel
You close panel.

* * *

>pull lever
As you pull on the lever, a secret panel opens in the wall of the cupboard.

>n
secret room (in Mystery machine)
You can see Villain and panel here.

In Mystery machine you can see Velma Dinkley, Shaggy Rogers, Fred Jones and Daphne Blake.

>villain, n
That would be a terrible idea.

Villain is unable to do that.

>fred, eat me
That would be a terrible idea.

(Fred Jones first taking yourself)
Fred Jones is unable to do that.

>fred, go north
Fred Jones is unable to do that.

>fred, get out of car
There is no reply.

>fred, get out of mystery machine
There is no reply.

>fred, get out
Fred Jones gets out of Mystery machine.

>shaggy, give me rope
That would be a terrible idea.

Shaggy Rogers is unable to do that.

>restart
Are you sure you want to restart?

>y
Scooby doo
An Interactive Fiction by Orion z
Release 1 / Serial number 130304 / Inform 7 build 6G60 (I6/v6.32 lib 6/12N) SD

Road (in Mystery machine)
In Mystery machine you can see Velma Dinkley, Shaggy Rogers, Fred Jones and Daphne Blake.

>take all
rope: That seems to belong to Shaggy Rogers.

>shaggy, give me rope
That would be a terrible idea.

Shaggy Rogers is unable to do that.

>shaggy, give me all
(the rope)
Shaggy Rogers is unable to do that.

* * *

>look
yard
As you pull up to the house, you see ghosts roaming around the yard. however, they seem harmless enough. to the north is a house.

You can see Daphne Blake, Fred Jones, Shaggy Rogers, Velma Dinkley and Mystery machine (empty) here.

>hello
(addressing Shaggy Rogers)
""Are you well?" Actually, we have a mystery to solve now. do you want to go north?

>n
House
A typical haunted house. you look around to the sight of ghosts everywhere. there is a cupboard and two doors here.

>open cupboard
You can't see any such thing.

>look
House
A typical haunted house. you look around to the sight of ghosts everywhere. there is a cupboard and two doors here.

>k
That's not a verb I recognise.

>n
cupboard
You can see a lever here.

>pull lever
As you pull on the lever, a secret panel opens in the wall of the cupboard.

>look
cupboard
Inside the cupboard, there is an open panel to your north.

You can see a lever here.

>n
secret room
You can see Villain and panel here.

>look
secret room
You can see Villain and panel here.

>hello
(addressing Villain)
"How are you?" asks Villain.

>n
You can't go that way.