Welcome to An Interactive Fiction version of Harry Potter.
                (If you ever need help, type help.)

Nearly ten years had passed since the Dursleys had woken up to find their nephew in the front step, but Privet Drive had hardly changed at all. The sun rose on the same tidy front gardens and lit up the brass number four on the Dursley's front door; it crept into their living-room, which was almost exactly the same as it had been on the night when Mr Dursley had seen that fateful news report about the owls.

>look
Cupboard under the stairs

* * *

Welcome to An Interactive Fiction version of Harry Potter.
                (If you ever need help, type help.)

Nearly ten years had passed since the Dursleys had woken up to find their nephew in the front step, but Privet Drive had hardly changed at all. The sun rose on the same tidy front gardens and lit up the brass number four on the Dursley's front door; it crept into their living-room, which was almost exactly the same as it had been on the night when Mr Dursley had seen that fateful news report about the owls.

>[enter]
Welcome to An Interactive Fiction version of Harry Potter.
                (If you ever need help, type help.)

Only the photographs on the mantlepiece really showed how much time had passed. Ten years ago, there had been lots of pictures of what looked like a large pink beach ball wearing different-coloured bobble hats - but Dudley Dursley was no longer a baby, and now the photographs showed a large, blond boy riding his first bicycle, on a roundabout at the fair, playing a computer game with his father, being hugged and kissed by his mother.

>[enter]
Welcome to An Interactive Fiction version of Harry Potter.
                (If you ever need help, type help.)

The room held no sign at all that another boy lived in the house too.
    Yet Harry Potter was still there, asleep at the moment, but not for long. His Aunt Petunia was awake and it was her shrill voice which made the first noise of the day.

>[enter]
Up! Get up! Now!

>look
Cupboard under the stairs

* * *

>[enter]
Up! Get up! Now!

>hel
I didn't understand that number.

* * *

>[enter]
Up! Get up! Now!

I beg your pardon?

* * *

>[enter]
Up! Get up! Now!

>sdte
That's not a verb I recognise.

* * *

>[enter]
Up! Get up! Now!

>[enter]
Harry Potter and the philosopher's stone
An Interactive Fiction by Orion Zymaris
Release 1 / Serial number 130704 / Inform 7 build 6G60 (I6/v6.32 lib 6/12N) SD
Cupboard under the stairs (in Bed)
You can barely see a small, dark room with lots of spiders and your few measly possessions. Not as interesting as the dream you were having - There had been a flying motorbike in it. You have a funny feeling that you've had the same dream before...

You can see Cupboard door (south), a pair of socks, a pair of shoes, a chess set, a roll of sellotape and glasses here.

>[enter]
Welcome to An Interactive Fic tion version of Harry Potter.
                (If you ever need help, type help.)

The room held no sign at all that another boy lived in the house too.
    Yet Harry Potter was still there, asleep at the moment, but not for long. His Aunt Petunia was awake and it was her shrill voice which made the first noise of the day.

* * *

>[enter]
Harry Potter and the philosopher's stone
An Interactive Fiction by Orion Zymaris
Release 1 / Serial number 130704 / Inform 7 build 6G60 (I6/v6.32 lib 6/12N) SD
Cupboard under the stairs (in Bed)
You can barely see a small, dark room with lots of spiders and your few measly possessions. Not as interesting as the dream you were having - There had been a flying motorbike in it. You have a funny feeling that you've had the same dream before...

You can see Cupboard door (south), a pair of socks, a pair of shoes, a chess set, a roll of sellotape and glasses here.

>look
Cupboard under the stairs (in Bed)
You can barely see a small, dark room with lots of spiders and your few measly possessions. Not as interesting as the dream you were having - There had been a flying motorbike in it. You have a funny feeling that you've had the same dream before...

You can see Cupboard door (west), a pair of socks, a pair of shoes, a chess set, a roll of sellotape and glasses here.

>look
Cupboard under the stairs (in Bed)
You can see a small, dark room with lots of spiders and your few measly possessions. Not as interesting as the dream you were having - There had been a flying motorbike in it. You have a funny feeling that you've had the same dream before...

"Up!" Screeches Petunia.

>Fine jerk
That's not a verb I recognise.

* * *

>look
Cupboard under the stairs (in Bed)
You can barely see a small, dark room with lots of spiders and your few measly possessions. Not as interesting as the dream you were having - There had been a flying motorbike in it. You have a funny feeling that you've had the same dream before...

You can see Cupboard door (west), a pair of socks, a pair of shoes, a chess set, a roll of sellotape and glasses here.

>get up
"Up!" Screeches Petunia.

You get out of Bed.

Cupboard under the stairs
You can barely see a small, dark room with lots of spiders and your few measly possessions. Not as interesting as the dream you were having - There had been a flying motorbike in it. You have a funny feeling that you've had the same dream before...

You can see Cupboard door (west), Bed (empty), a pair of socks, a pair of shoes, a chess set, a roll of sellotape and glasses here.

>w
(first opening Cupboard door)
"Get a move on, I want you to look after the bacon. And don't you dare let it burn, I want everything perfect on Duddy's birthday."

Hall
You can see Cupboard door (east) here.

* * *

>[enter]
Harry Potter and the philosopher's stone
An Interactive Fiction by Orion Zymaris
Release 1 / Serial number 130704 / Inform 7 build 6G60 (I6/v6.32 lib 6/12N) SD
Cupboard under the stairs (in Bed)
You can barely see a small, dark room with lots of spiders and your few measly possessions. Not as interesting as the dream you were having - There had been a flying motorbike in it. You have a funny feeling that you've had the same dream before...

You can see Cupboard door (south), a pair of socks, a pair of shoes, a chess set, a roll of sellotape and glasses here.

>get up
You get out of Bed.

Cupboard under the stairs
You can barely see a small, dark room with lots of spiders and your few measly possessions. Not as interesting as the dream you were having - There had been a flying motorbike in it. You have a funny feeling that you've had the same dream before...

You can see Cupboard door (south), Bed (empty), a pair of socks, a pair of shoes, a chess set, a roll of sellotape and glasses here.

>look
Cupboard under the stairs
You can see Bed (empty) here.

"Up!" Screeches Petunia.

* * *

>get up
You get out of Bed.

Cupboard under the stairs
You can barely see a small, dark room with lots of spiders and your few measly possessions. Not as interesting as the dream you were having - There had been a flying motorbike in it. You have a funny feeling that you've had the same dream before...

You can see Cupboard door (south), Bed (empty), a pair of socks, a pair of shoes, a chess set, a roll of sellotape and glasses here.

>s
(first opening Cupboard door)
"Up!" Screeches Petunia.

"Get a move on, I want you to look after the bacon. And don't you dare let it burn, I want everything perfect on Duddy's birthday.". You see the kitchen door slam as Petunia walks through and closes it.

Hall
You can see white door (west) and Cupboard door (north) here.

>w
(first opening white door)

Kitchen
You can see white door (east) and Aunt Petunia here.

>hello
(addressing Aunt Petunia)
You say hello to Aunt Petunia.

>bye
You say goodbye to Aunt Petunia.

>bye petunia
I only understood you as far as wanting to bye.

* * *

>[enter]
Harry Potter and the philosopher's stone
An Interactive Fiction by Orion Zymaris
Release 1 / Serial number 130704 / Inform 7 build 6G60 (I6/v6.32 lib 6/12N) SD
Cupboard under the stairs (in Bed)
You can barely see a small, dark room with lots of spiders and your few measly possessions. Not as interesting as the dream you were having - There had been a flying motorbike in it. You have a funny feeling that you've had the same dream before...

You can see Cupboard door (south), a pair of socks, a pair of shoes, a chess set, a roll of sellotape and glasses here.

>examine me
You see nothing special about yourself.

>get up
"Up!" Screeches Petunia.

* * *

>[enter]
Harry Potter and the philosopher's stone
An Interactive Fiction by Orion Zymaris
Release 1 / Serial number 130704 / Inform 7 build 6G60 (I6/v6.32 lib 6/12N) SD
Cupboard under the stairs (in Bed)
You can barely see a small, dark room with lots of spiders and your few measly possessions. Not as interesting as the dream you were having - There had been a flying motorbike in it. You have a funny feeling that you've had the same dream before...

You can see Cupboard door (south), a pair of socks, a pair of shoes, a chess set, a roll of sellotape and glasses here.

>wear socks
(first taking Pair of socks)
You put on Pair of socks.

* * *

>[enter]
Harry Potter and the philosopher's stone
An Interactive Fiction by Orion Zymaris
Release 1 / Serial number 130704 / Inform 7 build 6G60 (I6/v6.32 lib 6/12N) SD
Cupboard under the stairs (in Bed)
You can barely see a small, dark room with lots of spiders and your few measly possessions. Not as interesting as the dream you were having - There had been a flying motorbike in it. You have a funny feeling that you've had the same dream before...

You can see Cupboard door (south), a pair of socks, a pair of shoes, a chess set, a roll of sellotape and glasses here.

>Wear socks
(first taking pair of socks)
You flick a spider off the socks and hurriedly put them on.

>i
You are carrying:
  pair of socks (being worn)

"Up!" Screeches Petunia.

* * *

>[enter]
Harry Potter and the philosopher's stone
An Interactive Fiction by Orion Zymaris
Release 1 / Serial number 130704 / Inform 7 build 6G60 (I6/v6.32 lib 6/12N) SD
Cupboard under the stairs (in Bed)
You can barely see a small, dark room with lots of spiders and your few measly possessions. Not as interesting as the dream you were having - There had been a flying motorbike in it. You have a funny feeling that you've had the same dream before...

You can see Cupboard door (south), a pair of socks, a pair of shoes, a chess set, a roll of sellotape and glasses here.

>locate all
You can't use multiple objects with that verb.

>loook
That's not a verb I recognise.

>look
Cupboard under the stairs (in Bed)
You can see a small, dark room with lots of spiders and your few measly possessions. Not as interesting as the dream you were having - There had been a flying motorbike in it. You have a funny feeling that you've had the same dream before...

You can see Cupboard door (west), pair of socks and Shoes here.

>get up
"Up!" Screeches Petunia.

>wear shoes
(first taking Shoes)
You put on Shoes.

>i
You are carrying nothing. You are wearing Shoes.

* * *

>[enter]
Harry Potter and the philosopher's stone
An Interactive Fiction by Orion Zymaris
Release 1 / Serial number 130704 / Inform 7 build 6G60 (I6/v6.32 lib 6/12N) SD
Cupboard under the stairs (in Bed)
You can barely see a small, dark room with lots of spiders and your few measly possessions. Not as interesting as the dream you were having - There had been a flying motorbike in it. You have a funny feeling that you've had the same dream before...

You can see Cupboard door (south), a pair of socks, a pair of shoes, a chess set, a roll of sellotape and glasses here.

>wear shoes
(first taking the pair of shoes)
What, with no socks?

>wear socks
(first taking the pair of socks)
"Up!" Screeches Petunia.

"Up!" Screeches Petunia.

>i
You are carrying a pair of shoes. You are wearing a pair of socks.

>restart
Are you sure you want to restart?

>y
Welcome to An Interactive Fiction version of Harry Potter.
                (If you ever need help, type help.)

Nearly ten years had passed since the Dursleys had woken up to find their nephew in the front step, but Privet Drive had hardly changed at all. The sun rose on the same tidy front gardens and lit up the brass number four on the Dursley's front door; it crept into their living-room, which was almost exactly the same as it had been on the night when Mr Dursley had seen that fateful news report about the owls.

>[enter]
Welcome to An Interactive Fiction version of Harry Potter.
                (If you ever need help, type help.)

Only the photographs on the mantlepiece really showed how much time had passed. Ten years ago, there had been lots of pictures of what looked like a large pink beach ball wearing different-coloured bobble hats - but Dudley Dursley was no longer a baby, and now the photographs showed a large, blond boy riding his first bicycle, on a roundabout at the fair, playing a computer game with his father, being hugged and kissed by his mother.

* * *

>[enter]
Up! Get up! Now!

>[enter]
Harry Potter and the philosopher's stone
An Interactive Fiction by Orion Zymaris
Release 1 / Serial number 130704 / Inform 7 build 6G60 (I6/v6.32 lib 6/12N) SD
Cupboard under the stairs (in Bed)
You can see a small, dark room with lots of spiders and your few measly possessions. Not as interesting as the dream you were having - There had been a flying motorbike in it. You have a funny feeling that you've had the same dream before...

You can see Cupboard door (west), a pair of socks and a pair of shoes here.

>wear shoes
(first taking the pair of shoes)
What, with no socks?

>i
You are carrying a pair of shoes.

>wear socks
(first taking the pair of socks)
You flick a spider off the socks and hurriedly put them on.

>look
Cupboard under the stairs (in Bed)
You can see a small, dark room with lots of spiders and your few measly possessions. Not as interesting as the dream you were having - There had been a flying motorbike in it. You have a funny feeling that you've had the same dream before...

You can see Cupboard door (west) here.

>turn count
You can't see any such thing.

>turn
What do you want to turn?

>showme turn count
There seems to be no such object anywhere in the model world.

>showme turn
There seems to be no such object anywhere in the model world.

>showme turncount
There seems to be no such object anywhere in the model world.

* * *

>[enter]
Harry Potter and the philosopher's stone
An Interactive Fiction by Orion Zymaris
Release 1 / Serial number 130704 / Inform 7 build 6G60 (I6/v6.32 lib 6/12N) SD
Cupboard under the stairs (in Bed)
You can barely see a small, dark room with lots of spiders and your few measly possessions. Not as interesting as the dream you were having - There had been a flying motorbike in it. You have a funny feeling that you've had the same dream before...

You can see Cupboard door (south), a pair of socks, a pair of shoes, a chess set, a roll of sellotape and glasses here.

>turn count
0

>turn count
1
"Up!" Screeches Petunia.

>turn count
3

>restart
Are you sure you want to restart?

* * *

>wear shoes
(first taking the pair of shoes)
What, with no socks?

>wear socks
(first taking the pair of socks)
"Up!" Screeches Petunia.

You flick a spider off the socks and hurriedly put them on.

>remove socks
You take off the pair of socks.

>wear socks
You flick a spider off the socks and hurriedly put them on.