Harry Potter and the Philosopher's Stone
Based on by "Harry Potter and the Philosopher's stone" by J.K. Rowling. This game is not approved by J. K. Rowling. It exists because I am a fan of Harry Potter and text adventures, and is not a commercial venture. by Orion Zymaris
Release 1 / Serial number 131215 / Inform 7 build 6G60 (I6/v6.32 lib 6/12N) SD

Cupboard under the stairs (in Bed)
You can see a small, dark room with lots of spiders and your few measly possessions. Not as interesting as the dream you were having - There had been a flying motorbike in it. You have a funny feeling that you've had the same dream before...

You can see Cupboard door (south), a pair of socks, a pair of shoes, some assorted clothing, a chess set and a roll of sellotape here.

Name:

>look
Cupboard under the stairs

>showme me
yourself - person
location: in Harry's Room
singular-named, proper-named; unlit, inedible, portable; male
printed name: "Harry Potter"
printed plural name: "people"
indefinite article: none
description: none
initial appearance: none
carrying capacity: 100

* * *

>look
Cupboard under the stairs

>help
> General Game Commands (for specific hints, type hints)
   What does that top bar do?
   Acknowledgements
   Itinerary

>[down]
General Game Commands (for specific hints, type hints)
 > What does that top bar do?
   Acknowledgements
   Itinerary
   

   General Game Commands (for specific hints, type hints)
 > What does that top bar do?
   Acknowledgements
   Itinerary

>[down]
General Game Commands (for specific hints, type hints)
   What does that top bar do?
 > Acknowledgements
   Itinerary
   

   General Game Commands (for specific hints, type hints)
   What does that top bar do?
 > Acknowledgements
   Itinerary

>[down]
General Game Commands (for specific hints, type hints)
   What does that top bar do?
   Acknowledgements
 > Itinerary
   

   General Game Commands (for specific hints, type hints)
   What does that top bar do?
   Acknowledgements
 > Itinerary

>[down]
General Game Commands (for specific hints, type hints)
   What does that top bar do?
   Acknowledgements
   Itinerary
 > 

   General Game Commands (for specific hints, type hints)
   What does that top bar do?
   Acknowledgements
   Itinerary

>[enter]
*** Run-time problem P23: Attempt to look up a non-existent entry at column 1, row 5 of the table 'Table of Options'.

Please press SPACE to continue.

General Game Commands (for specific hints, type hints)
   What does that top bar do?
   Acknowledgements
   Itinerary
 > 

   General Game Commands (for specific hints, type hints)
   What does that top bar do?
   Acknowledgements
   Itinerary

>[up]
General Game Commands (for specific hints, type hints)
   What does that top bar do?
   Acknowledgements
 > Itinerary
   

   General Game Commands (for specific hints, type hints)
   What does that top bar do?
   Acknowledgements
 > Itinerary

>[enter]
'allo

Please press SPACE to continue.

General Game Commands (for specific hints, type hints)
   What does that top bar do?
   Acknowledgements
 > Itinerary
   

   General Game Commands (for specific hints, type hints)
   What does that top bar do?
   Acknowledgements
 > Itinerary

>[esc]
Cupboard under the stairs

>look
Cupboard under the stairs

* * *

>[enter]
That's not a verb I recognise.

>[enter]
That's not a verb I recognise.

>look
Cupboard under the stairs

>rape
I didn't understand that number.

>rape
I didn't understand that number.

>wte
I didn't understand that number.

>ewfwrgdtg
I didn't understand that number.

>ffff
I didn't understand that number.

>alex
I didn't understand that number.

>petunia
I didn't understand that number.

>eat
(yourself)
(first taking yourself)
You are always self-possessed.

>actions
Actions listing on.

>grge
I didn't understand that number.

>hello
[hailing]
There's no one here but you.
[hailing - failed the check what's being hailed rule]

* * *

>[enter]
That's not a verb I recognise.

>hel
I didn't understand that number.

>dsfd
I didn't understand that number.

* * *

>[enter]
That's not a verb I recognise.

I beg your pardon?

>fdgfg
I didn't understand that number.

* * *

>[enter]
That's not a verb I recognise.

>sdte
That's not a verb I recognise.

>999
That's not a verb I recognise.

>989
That's not a verb I recognise.

* * *

>[enter]
That's not a verb I recognise.

>[enter]
Welcome to An Interactive Fic tion version of Harry Potter.
                (If you ever need help, type help.)

The room held no sign at all that another boy lived in the house too.
    Yet Harry Potter was still there, asleep at the moment, but not for long. His Aunt Petunia was awake and it was her shrill voice which made the first noise of the day.

>[enter]
Welcome to An Interactive Fiction version of Harry Potter.
                (If you ever need help, type help.)

Nearly ten years had passed since the Dursleys had woken up to find their nephew in the front step, but Privet Drive had hardly changed at all. The sun rose on the same tidy front gardens and lit up the brass number four on the Dursley's front door; it crept into their living-room, which was almost exactly the same as it had been on the night when Mr Dursley had seen that fateful news report about the owls.

>[enter]
Welcome to An Interactive Fiction version of Harry Potter.
                (If you ever need help, type help.)

Only the photographs on the mantlepiece really showed how much time had passed. Ten years ago, there had been lots of pictures of what looked like a large pink beach ball wearing different-coloured bobble hats - but Dudley Dursley was no longer a baby, and now the photographs showed a large, blond boy riding his first bicycle, on a roundabout at the fair, playing a computer game with his father, being hugged and kissed by his mother.

>[enter]
Welcome to An Interactive Fic tion version of Harry Potter.
                (If you ever need help, type help.)

The room held no sign at all that another boy lived in the house too.
    Yet Harry Potter was still there, asleep at the moment, but not for long. His Aunt Petunia was awake and it was her shrill voice which made the first noise of the day.

>[enter]
Welcome to An Interactive Fiction version of Harry Potter.
                (If you ever need help, type help.)

Only the photographs on the mantlepiece really showed how much time had passed. Ten years ago, there had been lots of pictures of what looked like a large pink beach ball wearing different-coloured bobble hats - but Dudley Dursley was no longer a baby, and now the photographs showed a large, blond boy riding his first bicycle, on a roundabout at the fair, playing a computer game with his father, being hugged and kissed by his mother.

* * *

>[enter]
That's not a verb I recognise.

>look
Cupboard under the stairs
You can see a small, dark room with lots of spiders and your few measly possessions. Not as interesting as the dream you were having - There had been a flying motorbike in it. You have a funny feeling that you've had the same dream before...

You can see Cupboard door (south), Bed (empty), a pair of socks, a pair of shoes, a chess set and a roll of sellotape here.

>look
Cupboard under the stairs (in Bed)
You can barely see a small, dark room with lots of spiders and your few measly possessions. Not as interesting as the dream you were having - There had been a flying motorbike in it. You have a funny feeling that you've had the same dream before...

I need my glasses.

You can see Cupboard door (south), a pair of socks, a pair of shoes, a chess set, a roll of sellotape and glasses here.

"Up!" Screeches Petunia.

hi

>Fine jerk
That's not a verb I recognise.

>get up
You get out of Bed.

Cupboard under the stairs
You can see a small, dark room with lots of spiders and your few measly possessions. Not as interesting as the dream you were having - There had been a flying motorbike in it. You have a funny feeling that you've had the same dream before...

You can see Bed (empty) here.

>look
Cupboard under the stairs
You can see a small, dark room with lots of spiders and your few measly possessions. Not as interesting as the dream you were having - There had been a flying motorbike in it. You have a funny feeling that you've had the same dream before...

You can see Bed (empty) here.

* * *

>look
Cupboard under the stairs
You can see a small, dark room with lots of spiders and your few measly possessions. Not as interesting as the dream you were having - There had been a flying motorbike in it. You have a funny feeling that you've had the same dream before...

You can see Cupboard door (south), Bed (empty), a pair of socks, a pair of shoes, a chess set and a roll of sellotape here.

>get up
"Up!" Screeches Petunia.

You get out of Bed.

Cupboard under the stairs
You can barely see a small, dark room with lots of spiders and your few measly possessions. Not as interesting as the dream you were having - There had been a flying motorbike in it. You have a funny feeling that you've had the same dream before...

I need my glasses.

You can see Cupboard door (south), Bed (empty), a pair of socks, a pair of shoes, a chess set, a roll of sellotape and glasses here.

>w
(first opening Cupboard door)
"Get a move on, I want you to look after the bacon. And don't you dare let it burn, I want everything perfect on Duddy's birthday."

Hall
You can see Cupboard door (east) here.

>groan
It's not sexy times yet.

* * *

>get up
"Up!" Screeches Petunia.

You get out of Bed.

Cupboard under the stairs
You can barely see a small, dark room with lots of spiders and your few measly possessions. Not as interesting as the dream you were having - There had been a flying motorbike in it. You have a funny feeling that you've had the same dream before...

I need my glasses.

You can see Cupboard door (south), Bed (empty), a pair of socks, a pair of shoes, a chess set, a roll of sellotape and glasses here.

>wear socks. wear shoes.
(first taking the pair of socks)
You pick up the pair of socks from the ground.

You flick a spider off the socks and hurriedly put them on.

(first taking the pair of shoes)
You pick up the pair of shoes from the ground.

You put on the pair of shoes.

>s
(first opening Cupboard door)
"Get a move on, I want you to look after the bacon. And don't you dare let it burn, I want everything perfect on Duddy's birthday.". You see the kitchen door slam as Petunia walks through and closes it.

Hall
You can see white door (west) and Cupboard door (north) here.

* * *

>get up
"Up!" Screeches Petunia.

You get out of Bed.

Cupboard under the stairs
You can barely see a small, dark room with lots of spiders and your few measly possessions. Not as interesting as the dream you were having - There had been a flying motorbike in it. You have a funny feeling that you've had the same dream before...

I need my glasses.

You can see Cupboard door (south), Bed (empty), a pair of socks, a pair of shoes, a chess set, a roll of sellotape and glasses here.

>wear glasses
(first taking glasses)
You pick up glasses from the ground.

You put on glasses.

>w
You can't go that way.

>s
(first opening Cupboard door)
"Get a move on, I want you to look after the bacon. And don't you dare let it burn, I want everything perfect on Duddy's birthday.". You see the kitchen door slam as Petunia walks through and closes it. The sound of the frying pan being put on the cooker emenates from the kitchen.

Hall
You can see white door (west) and Cupboard door (north) here.

>w
(first opening white door)
Your Uncle makes a rare attempt to look at you and barks "Comb your hair!" by way of a morning greeting.

Kitchen
You can see the kitchen door (east), Aunt Petunia, Uncle Vernon, thirty-seven presents and a cooker (on which are the frying pan (in which is bacon) and spatula) here.

>eat bacon
(first taking bacon)
You eat bacon. Not bad.

>look
Kitchen
You can see the kitchen door (east), Aunt Petunia, Uncle Vernon, thirty-seven presents and a cooker (on which are the frying pan (empty) and spatula) here.

>look
Kitchen
You can see the kitchen door (east), Aunt Petunia, Uncle Vernon, thirty-seven presents and a cooker (on which are the frying pan (empty) and spatula) here.

>look
Kitchen
You can see the kitchen door (east), Aunt Petunia, Uncle Vernon, thirty-seven presents and a cooker (on which are the frying pan (empty) and spatula) here.

Aunt Petunia comes over to check the bacon. "Now i'll have to recook the bacon! You are not touching it again!"

* * *

>look
Cupboard under the stairs
You can see a small, dark room with lots of spiders and your few measly possessions. Not as interesting as the dream you were having - There had been a flying motorbike in it. You have a funny feeling that you've had the same dream before...

You can see Cupboard door (south), Bed (empty), a pair of socks, a pair of shoes, a chess set and a roll of sellotape here.

>s
(first opening Cupboard door)
"Up!" Screeches Petunia.

"Get a move on, I want you to look after the bacon. And don't you dare let it burn, I want everything perfect on Duddy's birthday.". You see the kitchen door slam as Petunia walks through and closes it. The sound of the frying pan being put on the cooker emenates from the kitchen. I'd better cook the breakfast.

Hall
You can see white door (west) and Cupboard door (north) here.

>w
(first opening white door)
Your Uncle makes a rare attempt to look at you and barks "Comb your hair!" by way of a morning greeting.

kitchen
You can see the kitchen door (east), Aunt Petunia, Uncle Vernon (hiding behind a newspaper), kitchen table (on which is two pieces of toast), thirty-seven presents, a cooker (on which is the frying pan (in which are egg and bacon)) and fridge (closed) here.

>cook food
You cook the eggs and bacon.

Dudley arrives in the kitchen with Petunia. He looks startlingly like Uncle Vernon. He has a large, pink face, not much neck, small, watery blue eyes and thick blond hair that lies smoothly on his thick, fat head. "Here's the birthday angel!" Crows aunt Petunia.

>[enter]
Dudley starts counting his presents.

>[enter]
"One..."

>[enter]
"Two..."

>[enter]
Three..."

>[enter]
"Five... No, four..."

>[enter]
"Five..."

>[enter]
"Six..."

>[enter]
"Seven..."

>[enter]
"Eight..."

>[enter]
"Nine..."

>[enter]
"Ten..."

>[enter]
Eleven..."

>[enter]
"Twelve..."

>[enter]
"Thirteen..."

>[enter]
"Fourteen..."

>[enter]
"Fifteen..."

>[enter]
"Sixteen..."

>[enter]
"Um... Seventeen..."

>[enter]
"Eighteen..."

>[enter]
"Nineteen..."

>[enter]
"Twenty..."

>[enter]
"Twenty one..."

>[enter]
"Twenty two..."

>[enter]
"Twenty three..."

>[enter]
"Twenty four..."

>[enter]
"Twenty five..."

>[enter]
"Twenty six..."

>[enter]
"Twenty seven..."

>[enter]
"Twenty eight..."

>[enter]
"Twenty nine..."

>[enter]
"Thirty..."

>[enter]
"Thirty-one..."

>[enter]
"Thirty-two..."

>[enter]
"Thirty-three..."

>[enter]
"Thirty-four..."

>[enter]
"Thirty-five..."

* * *

>orion
Your name for this pre-release test is "orion".

>settings
 > General Game Commands (for specific hints, type hints)
   Settings
   What does that top bar do?
   Acknowledgements
   Itinerary

   General Game Commands (for specific hints, type hints)
 > Settings
   What does that top bar do?
   Acknowledgements
   Itinerary
   
   General Game Commands (for specific hints, type hints)
 > Settings
   What does that top bar do?
   Acknowledgements
   Itinerary

   General Game Commands (for specific hints, type hints)
   Settings
 > What does that top bar do?
   Acknowledgements
   Itinerary
   
   General Game Commands (for specific hints, type hints)
   Settings
 > What does that top bar do?
   Acknowledgements
   Itinerary

   General Game Commands (for specific hints, type hints)
   Settings
   What does that top bar do?
 > Acknowledgements
   Itinerary
   
   General Game Commands (for specific hints, type hints)
   Settings
   What does that top bar do?
 > Acknowledgements
   Itinerary

   General Game Commands (for specific hints, type hints)
   Settings
   What does that top bar do?
   Acknowledgements
 > Itinerary
   
   General Game Commands (for specific hints, type hints)
   Settings
   What does that top bar do?
   Acknowledgements
 > Itinerary

Cupboard under the stairs
You can see a small, dark room with lots of spiders and your few measly possessions. Not as interesting as the dream you were having - There had been a flying motorbike in it. You have a funny feeling that you've had the same dream before...

You can see Cupboard door (south), Bed (empty), a pair of socks, a pair of shoes, some assorted clothing, a chess set and a roll of sellotape here.

I beg your pardon?

   General Game Commands (for specific hints, type hints)
   What does that top bar do?
   Acknowledgements
   Itinerary
   
 > Settings
   General Game Commands (for specific hints, type hints)
   What does that top bar do?
   Acknowledgements
   Itinerary
   
 > Settings

Please press SPACE to continue.

   General Game Commands (for specific hints, type hints)
   What does that top bar do?
   Acknowledgements
   Itinerary
   
 > Settings
   General Game Commands (for specific hints, type hints)
   What does that top bar do?
   Acknowledgements
   Itinerary
   
 > Settings

   General Game Commands (for specific hints, type hints)
   What does that top bar do?
   Acknowledgements
   Itinerary
 > 
   Settings
   General Game Commands (for specific hints, type hints)
   What does that top bar do?
   Acknowledgements
   Itinerary
 > 
   Settings

*** Run-time problem P23: Attempt to look up a non-existent entry at column 1, row 5 of the table 'Table of Options'.

Please press SPACE to continue.

   General Game Commands (for specific hints, type hints)
   What does that top bar do?
   Acknowledgements
   Itinerary
 > 
   Settings
   General Game Commands (for specific hints, type hints)
   What does that top bar do?
   Acknowledgements
   Itinerary
 > 
   Settings

   General Game Commands (for specific hints, type hints)
   What does that top bar do?
   Acknowledgements
   Itinerary
   
 > Settings
   General Game Commands (for specific hints, type hints)
   What does that top bar do?
   Acknowledgements
   Itinerary
   
 > Settings

   General Game Commands (for specific hints, type hints)
   What does that top bar do?
   Acknowledgements
   Itinerary
   
 > Settings
   General Game Commands (for specific hints, type hints)
   What does that top bar do?
   Acknowledgements
   Itinerary
   
 > Settings

>q
Cupboard under the stairs
You can see a small, dark room with lots of spiders and your few measly possessions. Not as interesting as the dream you were having - There had been a flying motorbike in it. You have a funny feeling that you've had the same dream before...

You can see Cupboard door (south), Bed (empty), a pair of socks, a pair of shoes, some assorted clothing, a chess set and a roll of sellotape here.

>cheats on
Now cheats are on.
"Up!" Screeches Petunia.

>settings
 > General Game Commands (for specific hints, type hints)
   What does that top bar do?
   Acknowledgements
   Itinerary
   Cheats
   Settings

 > General Game Commands (for specific hints, type hints)
   What does that top bar do?
   Acknowledgements
   Itinerary
   Cheats
   Settings

   General Game Commands (for specific hints, type hints)
 > What does that top bar do?
   Acknowledgements
   Itinerary
   Cheats
   Settings
   General Game Commands (for specific hints, type hints)
 > What does that top bar do?
   Acknowledgements
   Itinerary
   Cheats
   Settings

   General Game Commands (for specific hints, type hints)
   What does that top bar do?
 > Acknowledgements
   Itinerary
   Cheats
   Settings
   General Game Commands (for specific hints, type hints)
   What does that top bar do?
 > Acknowledgements
   Itinerary
   Cheats
   Settings

   General Game Commands (for specific hints, type hints)
   What does that top bar do?
   Acknowledgements
 > Itinerary
   Cheats
   Settings
   General Game Commands (for specific hints, type hints)
   What does that top bar do?
   Acknowledgements
 > Itinerary
   Cheats
   Settings

   General Game Commands (for specific hints, type hints)
   What does that top bar do?
   Acknowledgements
   Itinerary
 > Cheats
   Settings
   General Game Commands (for specific hints, type hints)
   What does that top bar do?
   Acknowledgements
   Itinerary
 > Cheats
   Settings

*** Run-time problem P23: Attempt to look up a non-existent entry at column 1, row 5 of the table 'Table of Options'.

Please press SPACE to continue.

   General Game Commands (for specific hints, type hints)
   What does that top bar do?
   Acknowledgements
   Itinerary
 > Cheats
   Settings
   General Game Commands (for specific hints, type hints)
   What does that top bar do?
   Acknowledgements
   Itinerary
 > Cheats
   Settings

   General Game Commands (for specific hints, type hints)
   What does that top bar do?
   Acknowledgements
   Itinerary
   Cheats
 > Settings
   General Game Commands (for specific hints, type hints)
   What does that top bar do?
   Acknowledgements
   Itinerary
   Cheats
 > Settings

These are the cheats commands:
teleport to/Apparate to [any room]
Move [any thing] to [any thing/any room]
Put [something off-stage]back in/on [somewhere]
take (anything, even fixed things or doors)
open sesame (opens and unlocks all doors and containers and vehicles in the whole game)
Change to [Person]
Increase score by [a number]
restore score (changes the score to what it was before being artificially inflated)
remove [something] from play

Please press SPACE to continue.

   General Game Commands (for specific hints, type hints)
   What does that top bar do?
   Acknowledgements
   Itinerary
   Cheats
 > Settings
   General Game Commands (for specific hints, type hints)
   What does that top bar do?
   Acknowledgements
   Itinerary
   Cheats
 > Settings

* * *

I beg your pardon?

I beg your pardon?

   General Game Commands (for specific hints, type hints)
   Settings
   What does that top bar do?
   Acknowledgements
 > Itinerary
   
   General Game Commands (for specific hints, type hints)
   Settings
   What does that top bar do?
   Acknowledgements
 > Itinerary

>q
Cupboard under the stairs
You can see a small, dark room with lots of spiders and your few measly possessions. Not as interesting as the dream you were having - There had been a flying motorbike in it. You have a funny feeling that you've had the same dream before...

You can see Cupboard door (south), Bed (empty), a pair of socks, a pair of shoes, some assorted clothing, a chess set and a roll of sellotape here.

I beg your pardon?

>cheats on
Now cheats are on.
"Up!" Screeches Petunia.

>help
 > General Game Commands (for specific hints, type hints)
   Settings
   What does that top bar do?
   Acknowledgements
   Itinerary
   Cheats

   General Game Commands (for specific hints, type hints)
 > Settings
   What does that top bar do?
   Acknowledgements
   Itinerary
   Cheats
   General Game Commands (for specific hints, type hints)
 > Settings
   What does that top bar do?
   Acknowledgements
   Itinerary
   Cheats

   General Game Commands (for specific hints, type hints)
   Settings
 > What does that top bar do?
   Acknowledgements
   Itinerary
   Cheats
   General Game Commands (for specific hints, type hints)
   Settings
 > What does that top bar do?
   Acknowledgements
   Itinerary
   Cheats

   General Game Commands (for specific hints, type hints)
   Settings
   What does that top bar do?
 > Acknowledgements
   Itinerary
   Cheats
   General Game Commands (for specific hints, type hints)
   Settings
   What does that top bar do?
 > Acknowledgements
   Itinerary
   Cheats

   General Game Commands (for specific hints, type hints)
   Settings
   What does that top bar do?
   Acknowledgements
 > Itinerary
   Cheats
   General Game Commands (for specific hints, type hints)
   Settings
   What does that top bar do?
   Acknowledgements
 > Itinerary
   Cheats

   General Game Commands (for specific hints, type hints)
   Settings
   What does that top bar do?
   Acknowledgements
   Itinerary
 > Cheats
   General Game Commands (for specific hints, type hints)
   Settings
   What does that top bar do?
   Acknowledgements
   Itinerary
 > Cheats

*** Run-time problem P23: Attempt to look up a non-existent entry at column 1, row 6 of the table 'Table of Options'.

Please press SPACE to continue.

* * *

I beg your pardon?

>q
Save failed.

Are you sure you want to quit?

Please answer yes or no.

>cheats on
Please answer yes or no.

>help
Please answer yes or no.

Please answer yes or no.

Please answer yes or no.

* * *

>help
 > General Game Commands (for specific hints, type hints)
   Settings
   What does that top bar do?
   Acknowledgements
   Itinerary

>q
Cupboard under the stairs
You can see a small, dark room with lots of spiders and your few measly possessions. Not as interesting as the dream you were having - There had been a flying motorbike in it. You have a funny feeling that you've had the same dream before...

You can see Cupboard door (south), Bed (empty), a pair of socks, a pair of shoes, some assorted clothing, a chess set and a roll of sellotape here.

"Up!" Screeches Petunia.

>cheats
I didn't understand that sentence.

>cheats on
Now cheats are on.

>h
That's not a verb I recognise.

>help
 > General Game Commands (for specific hints, type hints)
   Settings
   What does that top bar do?
   Acknowledgements
   Itinerary
   Cheats

* * *

*** Run-time problem P23: Attempt to look up a non-existent entry at column 1, row 6 of the table 'Table of Options'.

Please press SPACE to continue.

   General Game Commands (for specific hints, type hints)
   Settings
   What does that top bar do?
   Acknowledgements
   Itinerary
 > Cheats
   General Game Commands (for specific hints, type hints)
   Settings
   What does that top bar do?
   Acknowledgements
   Itinerary
 > Cheats

Please press SPACE to continue.

   General Game Commands (for specific hints, type hints)
   Settings
   What does that top bar do?
   Acknowledgements
   Itinerary
 > Cheats
   General Game Commands (for specific hints, type hints)
   Settings
   What does that top bar do?
   Acknowledgements
   Itinerary
 > Cheats

   General Game Commands (for specific hints, type hints)
   Settings
   What does that top bar do?
   Acknowledgements
 > Itinerary
   Cheats
   General Game Commands (for specific hints, type hints)
   Settings
   What does that top bar do?
   Acknowledgements
 > Itinerary
   Cheats

unfinished

Please press SPACE to continue.

   General Game Commands (for specific hints, type hints)
   Settings
   What does that top bar do?
   Acknowledgements
 > Itinerary
   Cheats
   General Game Commands (for specific hints, type hints)
   Settings
   What does that top bar do?
   Acknowledgements
 > Itinerary
   Cheats

* * *

Cupboard under the stairs
You can see a small, dark room with lots of spiders and your few measly possessions. Not as interesting as the dream you were having - There had been a flying motorbike in it. You have a funny feeling that you've had the same dream before...

You can see Cupboard door (south), Bed (empty), a pair of socks, a pair of shoes, some assorted clothing, a chess set and a roll of sellotape here.

   General Game Commands (for specific hints, type hints)
   What does that top bar do?
   Acknowledgements
   Itinerary
 > Settings
   
   General Game Commands (for specific hints, type hints)
   What does that top bar do?
   Acknowledgements
   Itinerary
 > Settings

   General Game Commands (for specific hints, type hints)
   What does that top bar do?
   Acknowledgements
   Itinerary
   Settings
 > 
   General Game Commands (for specific hints, type hints)
   What does that top bar do?
   Acknowledgements
   Itinerary
   Settings

 > Time delays are off

 > Time delays are on
 > Time delays are on

 > Time delays are off
 > Time delays are off

>e
 > Time delays are off

>q
   General Game Commands (for specific hints, type hints)
   What does that top bar do?
   Acknowledgements
   Itinerary
 > Settings

>q
Cupboard under the stairs
You can see a small, dark room with lots of spiders and your few measly possessions. Not as interesting as the dream you were having - There had been a flying motorbike in it. You have a funny feeling that you've had the same dream before...

You can see Cupboard door (south), Bed (empty), a pair of socks, a pair of shoes, some assorted clothing, a chess set and a roll of sellotape here.

* * *

>Orion
Your name for this pre-release test is "Orion".

>cheats on
Now cheats are on.

>help
 > General Game Commands (for specific hints, type hints)
   Settings
   What does that top bar do?
   Acknowledgements
   Itinerary
   Cheats

* * *

   General Game Commands (for specific hints, type hints)
   Settings
   What does that top bar do?
   Acknowledgements
 > Itinerary
   Cheats
   General Game Commands (for specific hints, type hints)
   Settings
   What does that top bar do?
   Acknowledgements
 > Itinerary
   Cheats

>q
   General Game Commands (for specific hints, type hints)
 > Settings
   What does that top bar do?
   Acknowledgements
   Itinerary
   Cheats

   General Game Commands (for specific hints, type hints)
   Settings
 > What does that top bar do?
   Acknowledgements
   Itinerary
   Cheats
   General Game Commands (for specific hints, type hints)
   Settings
 > What does that top bar do?
   Acknowledgements
   Itinerary
   Cheats

* * *

   General Game Commands (for specific hints, type hints)
   Settings
   What does that top bar do?
   Acknowledgements
   Itinerary
 > Cheats
   General Game Commands (for specific hints, type hints)
   Settings
   What does that top bar do?
   Acknowledgements
   Itinerary
 > Cheats

These are the cheats commands:
teleport to/Apparate to [any room]
Move [any thing] to [any thing/any room]
Put [something off-stage]back in/on [somewhere]
take (anything, even fixed things or doors)
open sesame (opens and unlocks all doors and containers and vehicles in the whole game)
Change to [Person]
Increase score by [a number]
restore score (changes the score to what it was before being artificially inflated)
remove [something] from play

Please press SPACE to continue.

   General Game Commands (for specific hints, type hints)
   Settings
   What does that top bar do?
   Acknowledgements
   Itinerary
 > Cheats
   General Game Commands (for specific hints, type hints)
   Settings
   What does that top bar do?
   Acknowledgements
   Itinerary
 > Cheats

* * *

>Orion
Your name for this pre-release test is "Orion".

>test me
(Testing.)

>[1] 000
That's not a verb I recognise.

>[2] s
(first opening Cupboard door)
"Get a move on, I want you to look after the bacon. And don't you dare let it burn, I want everything perfect on Duddy's birthday." 
You see the kitchen door slam as Petunia walks through and closes it. The sound of the frying pan being put on the cooker emenates from the kitchen. You'd better cook the breakfast.

Hall
You can see Staircase (up), a Dining room door (southwest), the living-room door (south), front door (east), kitchen door (west) and Cupboard door (north) here.

>[3] w
(first opening kitchen door)
Your Uncle makes a rare attempt to look at you and barks "Comb your hair!" by way of a morning greeting.

kitchen
You see Dudley here, counting his presents.

You can see kitchen door (east), Uncle Vernon (hiding behind a newspaper), Aunt Petunia, Dudley, a chair, kitchen table (on which is piece of toast), thirty-seven presents, a cooker (on which is a the frying pan (in which are egg and bacon)), fridge (closed) and sink here.

>[4] cook food
You cook the eggs and bacon.

>[5] wait
The telephone rings in the living room. Aunt Petunia goes to get it.

Time passes.

>[6] wait
Time passes.

>[7] wait
Aunt Petunia enters the kitchen looking angry and worried. "Bad news, Vernon. Mrs Figg's broken her leg. She can't take him" she says, jerking her head towards you. Dudley looks horrified. "He's not coming on my birthday!"

"Maybe you could just leave me here" you suggest. 

"And come back and find the house in ruins?" says Aunt Petunia.

"I won't blow up the house," you say.

"I suppose we could take him to the zoo, and leave him in the car," says Aunt Petunia.

"The car's new, he's not sitting in it alone..."
Dudley begins to cry loudly. He's not really crying, it's been years since he's done that, But he knows that Aunt Petunia will give him anything he wants if he does.

That's the doorbell. Must be Piers Polkiss, Dudley's friend. Dudley's stopped pretending to cry.

"Alright, let's go," says Petunia. Everyone leaves the kitchen and gets into the Dursley's car.

>[8] wait
Time passes.

>[9] e
Uncle Vernon takes you aside. "I'm warning you, I'm warning you now, boy - any funny business, anything at all - and you'll be in that cupboard from now until Christmas. " He proceeds, with some difficulty, to go through the front door.

>[10] e
(first opening front door)

Garden
To the east is privet drive. 

You can see front door (west), car (closed) (in which are Uncle Vernon, Piers Polkiss, Dudley and Aunt Petunia) and garage (closed) here.

>[11] open car
You open car.

>[12] get in car
"Everyone here?" says Uncle Vernon, craning his neck to check if everyone managed the short walk from the kitchen to the massively oversized and expensive company car.
"Yes, let's go, let's go!" chorus Dudley and Piers.

The car pulls out of the driveway.

highway (in car)
The highway is filled with large company cars like your uncle's, and people roaring around on motorbikes.

In car you can see Uncle Vernon, Piers Polkiss, Dudley and Aunt Petunia.

* * *

Uncle Vernon seizes you around the waist and throws you into the hall, while the others run after. The kitchen door closes behind them. "That does it." says Uncle Vernon. "I want you all ready to leave in five minutes. We're going away. Just pack some clothes. No arguments!"

Ten minutes later, everyone was in the car, speeding along the highway. They drove. And drove. Even Aunt Petunia didn't dare ask where they were going. They didn't stop to eat or drink all day.

By nightfall Dudley was howling. He'd never missed so much TV in his life, or gone so long without using his computer. Finally, you stop outside of a gloomy-looking hotel. Dudley and Harry shared a room with twin beds and damp, musty sheets. Dudley's snoring fills the room.

Over a dinner of stale cornflakes and cold tomatoes on toast, the owner of the hotel comes over. "'Scuse me, but is one of you Mr H. Potter? Only I got about an 'undred of these at the front desk." She holds up a letter.

Mr H. Potter
Room 17
Railview Hotel
Cokeworth

You try and grab the letter, but Uncle Vernon knocks your hand away. He follows the woman to get the letters. Within half an hour, you're back on the road again. "Wouldn't it be better just to go home, dear?" Aunt Petunia suggested. Uncle Vernon pays no attention. After hours of roaming, the car stops at the coast and Uncle Vernon gets out, locking the door at the same time. After a while, Dudley starts complaining. "It's Monday, and the Great Humberto's on tonight. I want to stay somewhere with television."
If it is Monday, then it's your birthday tomorrow. Of course, your birthdays are never very fun - last year, you recieved a coat-hanger and a pair of old socks that used to belong to Uncle Vernon. Still, you weren't eleven every day.

Uncle Vernon comes, smiling, back to the car, carrying a long, thin package, which he wouldn't tell Petunia about. "Found the perfect place!" he says. "Come on! Everyone out!"
You walk along the coast, before coming to a halt in front of an old rowing boat which your Uncle says was lent to you buy the  toothless old man standing next to him. Everyone hops into the boat, and are soon rowing towards a small, miserable looking shack on a rock in the middle of the ocean.

After reaching the rock, everyone gratefully clambers out of the boat. The shack smells horribly like seaweed. Uncle Vernon, who promised he'd brought rations, turned out to be in possession of four packets of crisps, and four bananas. After eating, he chucks the empty crisp packets into the fire and tries to light it, but they just shrivel up. "Could do with some of those letters now, eh?" he says. Aunt Petunia and Uncle Vernon go into the only other room, and Dudley sleeps on the sofa. You get the floor. You check Dudley's watch, on his arm which is sticking over the side of the sofa. 

Five minutes to go.

Shack
There is another small room to the east.

You can see sofa, fireplace (empty) and blanket here.

>[63] wait
Time passes.

4 minutes to go.

>[64] wait
Time passes.

3 minutes to go.

>[65] wait
Time passes.

2 minutes to go.

>[66] wait
Time passes.

1 minute to go.

>[67] wait
Time passes.

BOOM. The whole shack shivered. You sit bolt upright. Someone was outside, knocking to come in. 
BOOM. They knocked again. Dudley jerked awake. "Where's the cannon?" he said stupidly. 
There was a crash as Uncle Vernon skidded into the room, holding a rifle in his hands - now they knew what was in the package that he had brought with him.
"Who's there?" he shouted. "I warn you - I'm armed!;
There was a pause. Then -
SMASH!
The door was knocked off of its hinges and landed on the floor. A giant of a man was standing in the doorway. The giant squeezed his way into the hut. He picked up the door and fitted it back into it's frame. He turned around to look at them. 
"Couldn't make us a cup o" tea, could yeh? It's not been an easy journey..."
 The stranger strolled over to the sofa and told Dudley to move. Dudley instead ran squeaking over to his parents. 
"An here's Harry!" said the giant.

>hello
(addressing Dudley)
"I demand that you leave at one, sir!" says Uncle Vernon. "You are breaking and entering!"
The giant wrenched the gun out of Uncle Vernon's hands, and bent it into a knot, before throwing it aside. 
"I haven" seen you since you was only a baby. I'm Hagrid, by the way. Rubeus Hagrid. I got summat for yeh - it's in my coat. Here you go." 

He gives you a box which he removed from his jacket, which, upon opening, contained a large chocolate cake with Happy Birthday Harry written on it in green icing. "You wouldn' mind making some tea and sausages, would yeh? they're in my coat. Start by getting out the tea pot and puttin' some tea leaves in it. Then go to the other room to get some water in it." Hagrid bent down in front of the fire, and when he stood up a fire was roaring in the grate. 
You say hello to Dudley.

>settings
 > General Game Commands (for specific hints, type hints)
   Settings
   What does that top bar do?
   Acknowledgements
   Itinerary

* * *

   General Game Commands (for specific hints, type hints)
 > Settings
   What does that top bar do?
   Acknowledgements
   Itinerary
   
   General Game Commands (for specific hints, type hints)
 > Settings
   What does that top bar do?
   Acknowledgements
   Itinerary

 > Time delays are off

>q
   General Game Commands (for specific hints, type hints)
 > Settings
   What does that top bar do?
   Acknowledgements
   Itinerary

>q
Shack
There is another small room to the east. a fire is crackling merrily in the grate.

You can see hagrid's coat, cake, Hagrid, Uncle Vernon, Aunt Petunia, Dudley, sofa, fireplace (in which is fire) and blanket here.

* * *

>Orion
Your name for this pre-release test is "Orion".

>get up
You are already standing.

>s
(first opening Cupboard door)
"Up!" Screeches Petunia.

"Get a move on, I want you to look after the bacon. And don't you dare let it burn, I want everything perfect on Duddy's birthday." 
You see the kitchen door slam as Petunia walks through and closes it. The sound of the frying pan being put on the cooker emenates from the kitchen. You'd better cook the breakfast.

Hall
You can see Staircase (up), a Dining room door (southwest), the living-room door (south), front door (east), kitchen door (west) and Cupboard door (north) here.

>w
(first opening kitchen door)
Your Uncle makes a rare attempt to look at you and barks "Comb your hair!" by way of a morning greeting.

kitchen
You see Dudley here, counting his presents.

You can see kitchen door (east), Uncle Vernon (hiding behind a newspaper), Aunt Petunia, Dudley, a chair, kitchen table (on which is piece of toast), thirty-seven presents, a cooker (on which is a the frying pan (in which are egg and bacon)), fridge (closed) and sink here.

>wait. wait. wait.
Time passes.

The telephone rings in the living room. Aunt Petunia goes to get it.

Time passes.

Time passes.

>cook breakfast
You cook the eggs and bacon.

Aunt Petunia enters the kitchen looking angry and worried. "Bad news, Vernon. Mrs Figg's broken her leg. She can't take him" she says, jerking her head towards you. Dudley looks horrified. "He's not coming on my birthday!"

"Maybe you could just leave me here" you suggest. 

"And come back and find the house in ruins?" says Aunt Petunia.

"I won't blow up the house," you say.

"I suppose we could take him to the zoo, and leave him in the car," says Aunt Petunia.
"The car's new, he's not sitting in it alone..."
Dudley begins to cry loudly. He's not really crying, it's been years since he's done that, But he knows that Aunt Petunia will give him anything he wants if he does.

That's the doorbell. Must be Piers Polkiss, Dudley's friend. Dudley's stopped pretending to cry.
"Alright, let's go," says Petunia. Everyone leaves the kitchen and gets into the Dursley's car.

>settings
 > General Game Commands (for specific hints, type hints)
   Settings
   What does that top bar do?
   Acknowledgements
   Itinerary

* * *

 > Time delays are on
 > Time delays are on

>q
   General Game Commands (for specific hints, type hints)
 > Settings
   What does that top bar do?
   Acknowledgements
   Itinerary

>q
kitchen
You can see kitchen door (east), a chair, kitchen table (on which is piece of toast), thirty-seven presents, a cooker (on which is a the frying pan (in which are egg and bacon)), fridge (closed) and sink here.

>look
kitchen
You can see kitchen door (east), a chair, kitchen table (on which is piece of toast), thirty-seven presents, a cooker (on which is a the frying pan (in which are egg and bacon)), fridge (closed) and sink here.

>gonear car
Garden
To the east is privet drive. 

You can see front door (west), car (closed) (in which are Piers Polkiss, Dudley and Aunt Petunia) and garage (closed) here.

>get in car
You can't get into the closed car.

>open car
You open car.

>get in car
Uncle Vernon jumps in the car.
"Everyone here?" says Uncle Vernon, craning his neck to check if everyone managed the short walk from the kitchen to the massively oversized and expensive company car.

"Yes, let's go, let's go!" chorus Dudley and Piers.

The car pulls out of the driveway.

highway (in car)
The highway is filled with large company cars like your uncle's, and people roaring around on motorbikes.

In car you can see Uncle Vernon, Piers Polkiss, Dudley and Aunt Petunia.

"...roaring along like maniacs, the young hoodlums," says Uncle Vernon. 

You hear Dudley and Piers bickering.

* * *

>Orion
Your name for this pre-release test is "Orion".

>...
That's not a verb I recognise.

>...
That's not a verb I recognise.

* * *

>Orion
Your name for this pre-release test is "Orion".

>gonear street
street

>look
street

>restart
Save failed.

Are you sure you want to restart?

>y
"Up!" Screeches Petunia.

Harry Potter and the Philosopher's Stone
Influenced by "Harry Potter and the Philosopher's stone" by J.K. Rowling. by Orion Zymaris
Release 1 / Serial number 131210 / Inform 7 build 6G60 (I6/v6.32 lib 6/12N) SD

Cupboard under the stairs
You can see a small, dark room with lots of spiders and your few measly possessions. Not as interesting as the dream you were having - There had been a flying motorbike in it. You have a funny feeling that you've had the same dream before...

You can see Cupboard door (south), Bed (empty), a pair of socks, a pair of shoes, some assorted clothing, a chess set and a roll of sellotape here.

Name:

>Orion
Your name for this pre-release test is "Orion".

>showme street
street - room
singular-named, proper-named; lighted, unvisited, posture-friendly
printed name: "street"
printed plural name: none
indefinite article: none
description: none

* * *

>Orion
Your name for this pre-release test is "Orion".

>showme train
(train timetable)
train timetable - thing
location: in the station
singular-named, proper-named; unlit, inedible, fixed in place, neuter, ordinarily enumerated, unseen, unfamiliar, not engaged, raw
printed name: "train timetable"
printed plural name: none
indefinite article: none
description: "The next train is to London, in 6 minutes."
initial appearance: none
cost: 0 knute

* * *

>look
leaky cauldron
The leaky cauldron is small, dark and shabby. A few old women sit in one corner, drinking sherry. The barman was talking to a little man in a top hat. Everyone seems to know Hagrid. 

You can see Hagrid, a rusty old door (east), Tom, bar (on which is drink), Dedalus Diggle, Professor Quirrell, Doris Crockford, a small table, five chairs and five old women here.

>get coat
You pick up hagrid's coat from the ground.

>look in coatr
You can't see any such thing.

>look in coat
You find nothing of interest.

>look coat
there are a whole bunch of pockets all around the coat. try opening a pocket.

>open coat
You open pocket, revealing teapot and tea leaves.

>take teapot
You take teapot from pocket.

>take tea leaves
You take tea leaves from pocket.

>s
You can't go that way.

>w
You can't go that way.

>e
second bedroom
You can see a mouldy old bed (empty) and Dirty sink (in which is water) here.

>put water in teapot
(first taking water)

>put leaves in teapot
You put tea leaves into teapot.

>w
As you enter, Hagrid says "You never told him? You kept it from him for all these years?"

"Kept what from me?" you ask eagerly.

"STOP! I FORBID YOU!" says Uncle Vernon, panicking.

"Ah, go boil yer heads, both of yeh," says Hagrid. "Harry - yer a wizard."

"I'm a what?" you ask. 
"A wizard, and a good one i'd reckon, once yer trained up a bit. It's time you read your  letter." Hagrid hands you a letter.
You unfold the letter and read: 

HOGWARTS SCHOOL OF WITHCRAFT AND WIZADRY

Headmaster: Albus Dumbledore
(Order of Merlin, First Class, Grand Sorc., Chf. Warlock,
Supreme Mugwump, International Confed. of Wizards

Dear Mr Potter,
    We are pleased to inform you that you have a place at Hogwarts School of Witchcraft and Wizardry. Please find enclosed a list of all necessary books and equipment.
    Term begins on 1 September. We await your owl by no later than 31 July. 

Yours sincerely,

Minerva McGonagall
Deputy Headmistress.

You look up. "What does it mean, they await my owl?"
Hagrid, appearing to just have his memory jogged, reaches inside one of his coat's many pockets, and extracts a real, live owl. He also extracts a quill and a roll of parchment. You read the letter he is writing upside down:
Dear Mr Dumbledore,
Given Harry his letter. Taking him to buy his things tomorrow.
Weather's horrible. Hope you're well.
Hagrid
He rolls it up, and gives it to the owl, which takes the letter and flies out the window. "Alright Harry, it'd do to get some sleep before tomorrow. Here, use this." says Hagrid. He gives you his coat to sleep under, which you promptly do. 
You wake next morning.

* * *

>look
leaky cauldron
The leaky cauldron is small, dark and shabby. A few old women sit in one corner, drinking sherry. The barman was talking to a little man in a top hat. Everyone seems to know Hagrid. 

You can see Hagrid, a rusty old door (east), Tom, bar (on which is drink), Dedalus Diggle, Professor Quirrell, Doris Crockford, a small table, five chairs and five old women here.

>open pocket
You open one of the pockets at random, and find a large bunch of keys. Another pocket yields mint humbugs. Then you find slug pellets, and three more packets of sausages, before finally stumbling across a bag of strange-looking coins.

>take all
hagrid's coat: You pick up hagrid's coat from the ground.

cake: You pick up cake from the ground.

blanket: You pick up blanket from the ground.

teapot: 
You take teapot from pocket.
tea leaves: 
You take tea leaves from pocket.
letter: That seems to belong to Uncle Vernon.

>e
Second bedroom
The small room in which your aunt and uncle sleep. The door is to the west.

You can see a mouldy old bed (empty) and Dirty sink (in which is water) here.

>fill kettle
What do you want to fill teapot with?

>water
You must supply a second noun.
You fill the teapot with water. From the other room, Hagrid calls out to you. "How're you going there, Harry? anyway, I'm the keeper of keys at Hogwarts. Yeh'll know all about Hogwarts, o' course. 
"Er, no" you call back. "Sorry".

"Sorry?" barks Hagrid. "It's them that should be sorry! I knew you weren't getting the letters, but I still thought you'd know about Hogwarts, fer crying out loud! Didn't you ever wonder where your parents learnt it all?

"All what?"

"ALL WHAT! Don' you know - Don't you know anything, about yer parents world?

"What world?

"DURSLEY!" booms Hagrid.

>e
You can't go that way.

>w
As you enter, Hagrid says "You never told him? You kept it from him for all these years?"

"Kept what from me?" you ask eagerly.

"STOP! I FORBID YOU!" says Uncle Vernon, panicking.

"Ah, go boil yer heads, both of yeh," says Hagrid. "Harry - yer a wizard."

"I'm a what?" you ask. 
"A wizard, and a good one i'd reckon, once yer trained up a bit. It's time you read your  letter." Hagrid hands you a letter.
You unfold the letter and read: 

HOGWARTS SCHOOL OF WITHCRAFT AND WIZADRY

Headmaster: Albus Dumbledore
(Order of Merlin, First Class, Grand Sorc., Chf. Warlock,
Supreme Mugwump, International Confed. of Wizards

Dear Mr Potter,
    We are pleased to inform you that you have a place at Hogwarts School of Witchcraft and Wizardry. Please find enclosed a list of all necessary books and equipment.
    Term begins on 1 September. We await your owl by no later than 31 July. 

Yours sincerely,

Minerva McGonagall
Deputy Headmistress.

You look up. "What does it mean, they await my owl?"
Hagrid, appearing to just have his memory jogged, reaches inside one of his coat's many pockets, and extracts a real, live owl. He also extracts a quill and a roll of parchment. You read the letter he is writing upside down:
Dear Mr Dumbledore,
Given Harry his letter. Taking him to buy his things tomorrow.
Weather's horrible. Hope you're well.
Hagrid
He rolls it up, and gives it to the owl, which takes the letter and flies out the window. "Alright Harry, it'd do to get some sleep before tomorrow. Here, use this." says Hagrid. He gives you his coat to sleep under, which you promptly do. 
You wake next morning.

>look
You wake up.

Shack
There is another small room to the east. a fire is crackling merrily in the grate.

You can see hagrid's coat, cake, Hagrid, Uncle Vernon, Aunt Petunia, sofa, fireplace (in which is fire) and a window (empty) here.

>undo
Shack
[Previous turn undone.]

>showme me
yourself - person
    letter - open container
    tea leaves
    teapot - open container
        water
    blanket
    glasses (worn)
    shirt (worn) - shirt
    pants (worn) - pants
location: in Shack
singular-named, proper-named; unlit, inedible, portable, ordinarily enumerated, seen, unfamiliar, not engaged, raw; male, asleep
printed name: "Harry Potter"
printed plural name: "people"
indefinite article: none
description: "You're rather small and skinny for your age... the only thing you like about your appearance is your lighting shaped scar."
initial appearance: none
cost: 0 knute
carrying capacity: 100
posture: standing

>look
You wake up.

Shack
There is another small room to the east. a fire is crackling merrily in the grate.

You can see hagrid's coat, cake, Hagrid, Uncle Vernon, Aunt Petunia, sofa, fireplace (in which is fire) and a window (empty) here.

>showme me
yourself - person
    letter - open container
    tea leaves
    teapot - open container
        water
    blanket
    glasses (worn)
    shirt (worn) - shirt
    pants (worn) - pants
location: in Shack
singular-named, proper-named; unlit, inedible, portable, ordinarily enumerated, seen, unfamiliar, not engaged, raw; male
printed name: "Harry Potter"
printed plural name: "people"
indefinite article: none
description: "You're rather small and skinny for your age... the only thing you like about your appearance is your lighting shaped scar."
initial appearance: none
cost: 0 knute
carrying capacity: 100
posture: standing

>undo
Shack
[Previous turn undone.]

>undo
Shack
[Previous turn undone.]

>rules
Rules tracing now switched on. Type "rules off" to switch it off again, or "rules all" to include even rules which do not apply.

* * *

>open pocket
You open one of the pockets at random, and find a large bunch of keys. Another pocket yields mint humbugs. Then you find slug pellets, and three more packets of sausages, before finally stumbling across a bag of strange-looking coins.

>open bag
The owl holds out its leg, displaying a little, open pouch. It watches you expectantly.

>take 6 knuts
Knut: 
You take the Knut from bag of coins.
Knut: 
You take the Knut from bag of coins.
Knut: 
You take the Knut from bag of coins.
Knut: 
You take the Knut from bag of coins.
Knut: 
You take the Knut from bag of coins.
Knut: 
You take the Knut from bag of coins.

>look
Shack
There is another small room to the east. a fire is crackling merrily in the grate.

You can see hagrid's coat, cake, owl, a the shack's door (west), Hagrid, Uncle Vernon, Aunt Petunia, Dudley, sofa, fireplace (in which is fire) and a window (empty) here.

>put 5 knuts in pouch
Knut: 
Done.
Knut: 
Done.
Knut: 
Done.
Knut: 
Done.
Knut: 
Done.

The owl flutters out the open window. Hagrid gets up, yawning loudly, and says "Best be off Harry. Lots to do." He notices you looking at the coins in the bag, and says "I wouldn' worry 'bout money; Your parents left you some. It's in the wizard's bank, Gringotts.  We'll go there soon enough."

* * *

>look
leaky cauldron
The leaky cauldron is small, dark and shabby. A few old women sit in one corner, drinking sherry. The barman was talking to a little man in a top hat. Everyone seems to know Hagrid. 

You can see Hagrid, a rusty old door (east), Tom, bar (on which is drink), Dedalus Diggle, Professor Quirrell, Doris Crockford, a small table, five chairs and five old women here.

>look
Shack
There is another small room to the east. a fire is crackling merrily in the grate.

You can see hagrid's coat, cake, owl, Hagrid, Uncle Vernon, Aunt Petunia, Dudley, sofa, fireplace (in which is fire) and a window (empty) here.

>showme me
yourself - person
    letter - open container
    tea leaves
    teapot - open container
        water
    blanket
    glasses (worn)
    shirt (worn) - shirt
    pants (worn) - pants
location: in Shack
singular-named, proper-named; unlit, inedible, portable, ordinarily enumerated, seen, unfamiliar, not engaged, raw; male, awake
printed name: "Harry Potter"
printed plural name: "people"
indefinite article: none
description: "You're rather small and skinny for your age... the only thing you like about your appearance is your lighting shaped scar."
initial appearance: none
cost: 0 knute
carrying capacity: 100
posture: standing

>look
Shack
There is another small room to the east. a fire is crackling merrily in the grate.

You can see hagrid's coat, cake, owl, Hagrid, Uncle Vernon, Aunt Petunia, Dudley, sofa, fireplace (in which is fire) and a window (empty) here.

>eat owl
(first taking owl)
It doesn't seem like the owl would appreciate that. It ruffles it's feathers at you.

>take owl
It doesn't seem like the owl would appreciate that. It ruffles it's feathers at you.

>take owl
It doesn't seem like the owl would appreciate that. It ruffles it's feathers at you.

>take owl. take owl. punch owl.
It doesn't seem like the owl would appreciate that. It ruffles it's feathers at you.

It doesn't seem like the owl would appreciate that. It ruffles it's feathers at you.

Violence isn't the answer to this one.

>open pocket
That's already open.

>look coar
You can't see any such thing.

>look coat
there are a whole bunch of pockets all around the coat. try opening a pocket.

>open a pocket
That's already open.

>close pocket
You close pocket.

* * *

>look
leaky cauldron
The leaky cauldron is small, dark and shabby. A few old women sit in one corner, drinking sherry. The barman was talking to a little man in a top hat. Everyone seems to know Hagrid. 

You can see Hagrid, a rusty old door (east), Tom, bar (on which is drink), Dedalus Diggle, Professor Quirrell, Doris Crockford, a small table, five chairs and five old women here.

>take coa
You can't see any such thing.

>take coat
That's not yours.

>open pocket
You open one of the pockets at random, and find a large bunch of keys. Another pocket yields mint humbugs. Then you find slug pellets, and three more packets of sausages, before finally stumbling across a bag of strange-looking coins.

>take coins
You take bag of coins from pocket.

>open bag
The owl holds out its leg, displaying a little, open pouch. It watches you expectantly.

>look in bag
In bag of coins are ten Knuts, ten sickles and ten galleons.

>take 5 knuts
Knut: 
You take the Knut from bag of coins.
Knut: 
You take the Knut from bag of coins.
Knut: 
You take the Knut from bag of coins.
Knut: 
You take the Knut from bag of coins.
Knut: 
You take the Knut from bag of coins.

>put 5 knuts in puch
That noun did not make sense in this context.

>put 5 knuts in pouch
Knut: 
Done.
Knut: 
Done.
Knut: 
Done.
Knut: 
Done.
Knut: 
Done.

The owl flutters out the open window.

>undo
Shack
[Previous turn undone.]

* * *

>look
leaky cauldron
The leaky cauldron is small, dark and shabby. A few old women sit in one corner, drinking sherry. The barman was talking to a little man in a top hat. Everyone seems to know Hagrid. 

You can see Hagrid, a rusty old door (east), Tom, bar (on which is drink), Dedalus Diggle, Professor Quirrell, Doris Crockford, a small table, five chairs and five old women here.

>showme hagrid's coat
hagrid's coat - clothing
    pocket (part of hagrid's coat) - open container
location: worn by Hagrid in the rock
singular-named, proper-named; unlit, inedible, portable, wearable, neuter, ordinarily enumerated, seen, unfamiliar, not engaged, raw
printed name: "hagrid's coat"
printed plural name: "clothings"
indefinite article: none
description: "there are a whole bunch of pockets all around the coat. try opening a pocket."
initial appearance: none
cost: 0 knute

>i hagrid
Hagrid is carrying nothing. Hagrid is wearing hagrid's coat, shirt and pants.

>w
(first opening the the shack's door)

rock
You can see Uncle Vernon's borrowed rowing boat bobbing in the water.

You can see a the shack's door (east), Hagrid and boat (empty) here.

>take hagrid
I don't suppose Hagrid would care for that.

>take hagrid's coat
That's not yours.

>get in baot
You can't see any such thing.

>get in boat
You get into boat.

* * *

>look
leaky cauldron
The leaky cauldron is small, dark and shabby. A few old women sit in one corner, drinking sherry. The barman was talking to a little man in a top hat. Everyone seems to know Hagrid. 

You can see Hagrid, a rusty old door (east), Tom, bar (on which is drink), Dedalus Diggle, Professor Quirrell, Doris Crockford, a small table, five chairs and five old women here.

>w
(first opening the the shack's door)

rock
You can see Uncle Vernon's borrowed rowing boat bobbing in the water.

You can see a the shack's door (east), Hagrid and boat (empty) here.

"Well, get in Harry", says Hagrid.

>get in boat
You get into boat.

"Well, get in Harry", says Hagrid.

* * *

>look
leaky cauldron
The leaky cauldron is small, dark and shabby. A few old women sit in one corner, drinking sherry. The barman was talking to a little man in a top hat. Everyone seems to know Hagrid. 

You can see Hagrid, a rusty old door (east), Tom, bar (on which is drink), Dedalus Diggle, Professor Quirrell, Doris Crockford, a small table, five chairs and five old women here.

>showme train
train - transparent closed container
    yourself - person
        tickets
        letter - open container
        tea leaves
        teapot - open container
            water
        blanket
        glasses (worn)
        shirt (worn) - shirt
        pants (worn) - pants
    Hagrid - person
        hagrid's coat (worn) - clothing
        shirt (worn) - shirt
        pants (worn) - pants
location: in the station
singular-named, proper-named; unlit, inedible, fixed in place, neuter, ordinarily enumerated, seen, unfamiliar, not engaged, raw; enterable, transparent, closed, openable, unlocked
printed name: "train"
printed plural name: "containers"
indefinite article: none
description: none
initial appearance: none
cost: 0 knute
carrying capacity: 100
posture: seated

>i
You are carrying tickets, letter, tea leaves, teapot and blanket. You are wearing glasses, a shirt and a pants.

* * *

>look
leaky cauldron
The leaky cauldron is small, dark and shabby. A few old women sit in one corner, drinking sherry. The barman was talking to a little man in a top hat. Everyone seems to know Hagrid. 

You can see Hagrid, a rusty old door (east), Tom, bar (on which is drink), Dedalus Diggle, Professor Quirrell, Doris Crockford, a small table, five chairs and five old women here.

>read list
HOGWARTS SCHOOL OF WITCHCRAFT AND WIZARDRY

Uniform
First year students will require:
    1. Three sets of plain work robes (black)
    2. One plain pointed hat (black) for day wear
    3. One pair of protective gloves (dragon hide or similar)
    4. One winter cloak (black, silver fastenings)
Please note that all pupils' clothes should carry name tags

Set Books
All students should have a copy of each of the following:
The standard Book of Spells (Grade 1)  by Miranda Goshawk
A History of Magic by Bathilda Bagshot
Magical Theory by Adalbert Waffling
A Beginner's Guide to  Transfiguration by Emeric Switch
One Thousand Magical Herbs and Fungi by Phyllida Spore
Magical Drafts and Potions by Arsenius Jigger
Fantastic Beasts and Where to Find Them by Newt Scamander
The Dark Forces: A Guide to Self-Protection by Quentin Trimble

Other Equipment
    1 wand
    1 cauldron (pewter, standard size 2)
    1 set glass or crystal phials
    1 telescope
    1 set brass scales

Students may also bring an owl OR a cat OR a toad

PARENTS ARE REMINDED THAT FIRST YEARS ARE NOT ALLOWED THEIR OWN BROOMSTICKS

"Can we buy all of this in London?" you ask. 
"If you know where to go", says Hagrid. "Hey look, we're here!"
Hagrid pulls you off the train and into a small bar. "This, Harry, is the leaky cauldron."
leaky cauldron
The leaky cauldron is small, dark and shabby. A few old women sit in one corner, drinking sherry. The barman was talking to a little man in a top hat. Everyone seems to know Hagrid. 

The barman asks "The usual, Hagrid?"
"Can't. Tom, I'm on Hogwarts Business. I'm taking Harry here to buy his school things."

The room goes quiet. "Good lord. Can it be... can it be Harry Potter?"
What seems like the entire bar queues up to shake your hand; some keep coming back. 
"Welcome back Mr Potter, Welcome back!"
"So proud, Mr Potter, I'm just so proud - "
"P-P-Potter, c-can't tell you how p-pleased I am to meet you."
"Harry, this is Professor Quirrell. He's a Hogwarts teacher." says hagrid.

* * *

>look
leaky cauldron
The leaky cauldron is small, dark and shabby. A few old women sit in one corner, drinking sherry. The barman was talking to a little man in a top hat. Everyone seems to know Hagrid. 

You can see Hagrid, a rusty old door (east), Tom, bar (on which is drink), Dedalus Diggle, Professor Quirrell, Doris Crockford, a small table, five chairs and five old women here.

>look old women
Old woman: The group are all staring at you. The bottle of Sherry, for the first time, sits forgotten on their table.

Old woman: The group are all staring at you. The bottle of Sherry, for the first time, sits forgotten on their table.

Old woman: The group are all staring at you. The bottle of Sherry, for the first time, sits forgotten on their table.

Old woman: The group are all staring at you. The bottle of Sherry, for the first time, sits forgotten on their table.

Old woman: The group are all staring at you. The bottle of Sherry, for the first time, sits forgotten on their table.

>look old woman
The group are all staring at you. The bottle of Sherry, for the first time, sits forgotten on their table.

* * *

>look
leaky cauldron
The leaky cauldron is small, dark and shabby. A few old women sit in one corner, drinking sherry. The barman was talking to a little man in a top hat. Everyone seems to know Hagrid. 

You can see Hagrid, a rusty old door (east), Tom, bar (on which is drink), Dedalus Diggle, Professor Quirrell, Doris Crockford, a small table, five chairs and five old women here.

>e
(first opening the rusty old door)

courtyard
"See? I told you that you're famous. Even Professor Quirrell was trembling ter meet yeh - mind you, he's usually tremblin'. Poor bloke. He was fine until he went on a trip one year to experience the dark arts first hand, but they say he met some vampires in the Black Forest and he had some trouble with a hag, and he's never been the same since."

You can see a rusty old door (west) here.

>i
You are carrying tickets, letter, tea leaves, teapot and blanket. You are wearing glasses, a shirt and a pants.

>w
leaky cauldron
The leaky cauldron is small, dark and shabby. A few old women sit in one corner, drinking sherry. The barman was talking to a little man in a top hat. Everyone seems to know Hagrid. 

You can see a rusty old door (east), Hagrid, Tom, Dedalus Diggle, Professor Quirrell, Doris Crockford, a small table, five chairs, five old women and bar here.

>put tea leaves under hagrid
That would be ridiculous.

>put tea leaves under table
(the small table)
You put tea leaves under small table.

>look under table
underneath the small table is tea leaves.

>take tea leaves
You take tea leaves from under small table.

>look under bar
There is nothing underneath bar.

>hello tom
"Is there anything I can do for you, Mister Potter?" Tom wheezes.

>action
That's not a verb I recognise.

>actions
Actions listing on.

>hello tom
[saying hello to Tom]
You are already talking to Tom.
[saying hello to Tom - failed the can't greet current interlocutor rule]

>buy drink
You can't see any such thing.

>buy tom
[buying Tom]
Tom turns around to make you Tom, revealing a button on the wall.

Nothing is on sale.
[buying Tom - failed the block buying rule]

>ask tom for tom
[requesting Tom for Tom]
[requesting Tom for Tom - succeeded]

>look
[looking]
leaky cauldron
The leaky cauldron is small, dark and shabby. A few old women sit in one corner, drinking sherry. The barman was talking to a little man in a top hat. Everyone seems to know Hagrid. 

You can see a rusty old door (east), Hagrid, Tom, button, Dedalus Diggle, Professor Quirrell, Doris Crockford, a small table, five chairs, five old women and bar here.

[looking - succeeded]

* * *

>look
leaky cauldron
The leaky cauldron is small, dark and shabby. A few old women sit in one corner, drinking sherry. The barman was talking to a little man in a top hat. Everyone seems to know Hagrid. 

You can see Hagrid, a rusty old door (east), Tom, bar (on which is drink), Dedalus Diggle, Professor Quirrell, Doris Crockford, a small table, five chairs and five old women here.

>buy sdgf
Tom turns around to make you a nothing, revealing a button on the wall.

>buy tom
Tom turns around to make you a nothing, revealing a button on the wall.

>buy adrink
Tom turns around to make you a nothing, revealing a button on the wall.

* * *

>scenes
Scene 'Entire Game' playing (for -540 mins now)
Scene 'Dudley's birthday breakfast' ended
Scene 'zoo' ended
Scene 'Camera challenge' ended
Scene 'zoo aftermath' ended
Scene 'letters from no-one' ended
Scene 'post' ended
Scene 'Hagrid's scene' playing (for 0 mins now)
(Scene monitoring now switched on. Type "scenes off" to switch it off again.)

>stats
That's not a verb I recognise.

* * *

>s
You can't go that way.

>n
You can't go that way.

>w
You can't go that way.

>e
"I demand that you leave at one, sir!" says Uncle Vernon. "You are breaking and entering!"
The giant wrenched the gun out of Uncle Vernon's hands, and bent it into a knot, before throwing it aside. 
"I haven" seen you since you was only a baby. I'm Hagrid, by the way. Rubeus Hagrid. I got summat for yeh - it's in my coat. Here you go." 

He gives you a box which he removed from his jacket, which, upon opening, contained a large chocolate cake with Happy Birthday Harry written on it in green icing. "You wouldn' mind making some tea and sausages, would yeh? they're in my coat. Start by getting out the tea pot and puttin' some tea leaves in it. Then go to the other room to get some water." Hagrid bent down in front of the fire, and when he stood up a fire was roaring in the grate. 
Second bedroom
You can see a mouldy old bed (empty) and Dirty sink (in which is water) here.

* * *

>look
Shack
There is another small room to the east. a fire is crackling merrily in the grate.

You can see hagrid's coat, cake, Hagrid, Uncle Vernon, Aunt Petunia, Dudley, sofa, fireplace (in which is fire) and blanket here.

>look coat
there are a whole bunch of pockets all around the coat. try opening a pocket.

>open pocket
You open pocket, revealing teapot and tea leaves.

>take teapot
You take teapot from pocket.

>take tea
You take tea leaves from pocket.

>w
You can't go that way.

>e
Second bedroom
You can see a mouldy old bed (empty) and Dirty sink (in which is water) here.

>fill kettle
What do you want to fill teapot with?

>fill kettle with water
You must supply a second noun.
You fill the teapot with water. From the other room, Hagrid calls out to you. "How're you going there, Harry? anyway, I'm the keeper of keys at Hogwarts. Yeh'll know all about Hogwarts, o' course. 
"Er, no" you call back. "Sorry".

"Sorry?" barks Hagrid. "It's them that should be sorry! I knew you weren't getting the letters, but I still thought you'd know about Hogwarts, fer crying out loud! Didn't you ever wonder where your parents learnt it all?

"All what?"

"ALL WHAT! Don' you know - Don't you know anything, about yer parents world?

"What world?

"DURSLEY!" booms Hagrid.

* * *

>put water in teapot
(first taking water)

You fill the teapot with water. From the other room, Hagrid calls out to you. "How're you going there, Harry? anyway, like I told you, I'm the keeper of keys at Hogwarts. Yeh'll know all about Hogwarts, o' course. 
"Er, no" you call back. "Sorry".

"Sorry?" barks Hagrid. "It's them that should be sorry! I knew you weren't getting the letters, but I still thought you'd know about Hogwarts, fer crying out loud! Didn't you ever wonder where your parents learnt it all?

"All what?"

"ALL WHAT! Don' you know - Don't you know anything, about yer parents world?

"What world?

"DURSLEY!" booms Hagrid.

>undo
Second bedroom
[Previous turn undone.]

>action
That's not a verb I recognise.

* * *

>actions
Actions listing on.

>put water in teapot
[inserting water into teapot]
(first taking water)

[(1) taking water - silently]
[(2) inserting water into teapot - silently]
You fill the teapot with water. From the other room, Hagrid calls out to you. "How're you going there, Harry? anyway, like I told you, I'm the keeper of keys at Hogwarts. Yeh'll know all about Hogwarts, o' course. 
"Er, no" you call back. "Sorry".

"Sorry?" barks Hagrid. "It's them that should be sorry! I knew you weren't getting the letters, but I still thought you'd know about Hogwarts, fer crying out loud! Didn't you ever wonder where your parents learnt it all?

"All what?"

"ALL WHAT! Don' you know - Don't you know anything, about yer parents world?

"What world?

"DURSLEY!" booms Hagrid.
[(2) inserting water into teapot - silently - succeeded]
[(1) taking water - silently - succeeded]
[inserting water into teapot - succeeded]

>i
[taking inventory]
You are carrying tea leaves and teapot. You are wearing glasses, a shirt and a pants.
[taking inventory - ended without result]

>inv hagrid
[taking another person's inventory Hagrid]
Hagrid is carrying nothing. Hagrid is wearing shirt and pants.

[taking another person's inventory Hagrid - succeeded]

>locate hagrid's coat
[requesting item location hagrid's coat]
hagrid's coat is in Shack.
hagrid's coat is not engaged.

[requesting item location hagrid's coat - succeeded]

>move hagrid's coat to hagrid
You can't see any such thing.

>cheats on
[switching cheats on]
Now cheats are on.
[switching cheats on - succeeded]

>move hagrid's coat to hagrid
[moving to hagrid's coat]
You move hagrid's coat to Hagrid.

[moving to hagrid's coat - succeeded]

>locate hagrid's coat
[requesting item location hagrid's coat]
hagrid's coat is in Shack.
hagrid's coat is not engaged.

[requesting item location hagrid's coat - succeeded]

>move hagrid's coat to hagrid
[moving to hagrid's coat]
You move hagrid's coat to Hagrid.

[moving to hagrid's coat - succeeded]

>look
[looking]
Second bedroom
You can see a mouldy old bed (empty) and Dirty sink (empty) here.

[looking - succeeded]

>e
[going east]
You can't go that way.
[going east - failed the can't go that way rule]

>w
[going west]
As you enter, Hagrid says "You never told him? You kept it from him for all these years?"

"Kept what from me?" you ask eagerly.

"STOP! I FORBID YOU!" says Uncle Vernon, panicking.

"Ah, go boil yer heads, both of yeh," says Hagrid. "Harry - yer a wizard."

"I'm a what?" you ask. 
"A wizard, and a good one i'd reckon, once yer trained up a bit. It's time you read your  letter." Hagrid hands you a letter.
[(1) opening letter]
[(1) opening letter - succeeded]

[(1) examining letter]
You unfold the letter and read: 

HOGWARTS SCHOOL OF WITHCRAFT AND WIZADRY

Headmaster: Albus Dumbledore
(Order of Merlin, First Class, Grand Sorc., Chf. Warlock,
Supreme Mugwump, International Confed. of Wizards

Dear Mr Potter,
    We are pleased to inform you that you have a place at Hogwarts School of Witchcraft and Wizardry. Please find enclosed a list of all necessary books and equipment.
    Term begins on 1 September. We await your owl by no later than 31 July. 

Yours sincerely,

Minerva McGonagall
Deputy Headmistress.

[(1) examining letter - succeeded]

You look up. "What does it mean, they await my owl?"
Hagrid, appearing to just have his memory jogged, reaches inside one of his coat's many pockets, and extracts a real, live owl. He also extracts a quill and a roll of parchment. You read the letter he is writing upside down:
Dear Mr Dumbledore,
Given Harry his letter. Taking him to buy his things tomorrow.
Weather's horrible. Hope you're well.
Hagrid
He rolls it up, and gives it to the owl, which takes the letter and flies out the window. "Alright Harry, it'd do to get some sleep before tomorrow. Here, use this." says Hagrid. He gives you his coat to sleep under, which you promptly do. 
You wake next morning.
[going west - succeeded]

>actions off
Actions listing off.

>look
Shack
There is another small room to the east. a fire is crackling merrily in the grate.

You can see hagrid's coat, cake, Hagrid, Uncle Vernon, Aunt Petunia, Dudley, sofa, fireplace (in which is fire) and blanket here.

>get up
You are already standing.

>look hagridf
You can't see any such thing.

>look hagrid
You see nothing special about Hagrid.

* * *

>loook
Shack
There is another small room to the east.

You can see Hagrid, Uncle Vernon, Aunt Petunia, Dudley, sofa, fireplace (in which is fire) and blanket here.

"I demand that you leave at one, sir!" says Uncle Vernon. "You are breaking and entering!"
The giant wrenched the gun out of Uncle Vernon's hands, and bent it into a knot, before throwing it aside. 
"I haven" seen you since you was only a baby. I'm Hagrid, by the way. Rubeus Hagrid. I got summat for yeh - it's in my coat. Here you go." 

He gives you a box which he removed from his jacket, which, upon opening, contained a large chocolate cake with Happy Birthday Harry written on it in green icing. "You wouldn' mind making some tea and sausages, would yeh? they're in my coat. Start by getting out the tea pot and puttin' some tea leaves in it. Then go to the other room to get some water." Hagrid bent down in front of the fire, and when he stood up a fire was roaring in the grate.

>open pocket
You open pocket, revealing teapot and tea leaves.

>take all
hagrid's coat: You pick up hagrid's coat from the ground.

cake: You pick up cake from the ground.

blanket: You pick up blanket from the ground.

teapot: 
You take teapot from pocket.
tea leaves: 
You take tea leaves from pocket.
letter: That seems to belong to Uncle Vernon.

* * *

>i
You are carrying tea leaves, teapot and blanket. You are wearing glasses, a shirt and a pants.

>look in teapot
In teapot is water.

>look
Second bedroom
The small room in which your aunt and uncle sleep. The door is to the west.

You can see a mouldy old bed (empty) and Dirty sink (empty) here.

>w
As you enter, Hagrid says "You never told him? You kept it from him for all these years?"

"Kept what from me?" you ask eagerly.

"STOP! I FORBID YOU!" says Uncle Vernon, panicking.

"Ah, go boil yer heads, both of yeh," says Hagrid. "Harry - yer a wizard."

"I'm a what?" you ask. 
"A wizard, and a good one i'd reckon, once yer trained up a bit. It's time you read your  letter." Hagrid hands you a letter.
You unfold the letter and read: 

HOGWARTS SCHOOL OF WITHCRAFT AND WIZADRY

Headmaster: Albus Dumbledore
(Order of Merlin, First Class, Grand Sorc., Chf. Warlock,
Supreme Mugwump, International Confed. of Wizards

Dear Mr Potter,
    We are pleased to inform you that you have a place at Hogwarts School of Witchcraft and Wizardry. Please find enclosed a list of all necessary books and equipment.
    Term begins on 1 September. We await your owl by no later than 31 July. 

Yours sincerely,

Minerva McGonagall
Deputy Headmistress.

You look up. "What does it mean, they await my owl?"
Hagrid, appearing to just have his memory jogged, reaches inside one of his coat's many pockets, and extracts a real, live owl. He also extracts a quill and a roll of parchment. You read the letter he is writing upside down:
Dear Mr Dumbledore,
Given Harry his letter. Taking him to buy his things tomorrow.
Weather's horrible. Hope you're well.
Hagrid
He rolls it up, and gives it to the owl, which takes the letter and flies out the window. "Alright Harry, it'd do to get some sleep before tomorrow. Here, use this." says Hagrid. He gives you his coat to sleep under, which you promptly do. 
You wake next morning.

>look
You wake up.

Shack
There is another small room to the east. a fire is crackling merrily in the grate.

You can see hagrid's coat, cake, Hagrid, Uncle Vernon, Aunt Petunia, sofa and fireplace (in which is fire) here.

>l
Shack
There is another small room to the east. a fire is crackling merrily in the grate.

You can see hagrid's coat, cake, Hagrid, Uncle Vernon, Aunt Petunia, sofa and fireplace (in which is fire) here.

>a
What do you want to a?

>listen
You hear a loud tapping noise. There's Aunt Petunia, you think, come to wake you up. You wished that yesterday was real, that you really where going off to a wizards school. You open your eyes, to the sight of the dark, damp hut. Hagrid is lying in a corner, snoring loudly.

there's nothing to hear.

>undo
Shack
[Previous turn undone.]

>actopns
You need to specify who you want to speak to.

>actions
Actions listing on.

>listen
[listening to Shack]
You hear a loud tapping noise. There's Aunt Petunia, you think, come to wake you up. You wished that yesterday was real, that you really where going off to a wizards school. You open your eyes, to the sight of the dark, damp hut. Hagrid is lying in a corner, snoring loudly.

there's nothing to hear.
[listening to Shack - succeeded]

>look
[looking]
Shack
There is another small room to the east. a fire is crackling merrily in the grate.

You can see hagrid's coat, cake, Hagrid, Uncle Vernon, Aunt Petunia, sofa and fireplace (in which is fire) here.

[looking - succeeded]

>take off coat
[taking off hagrid's coat]
(first taking hagrid's coat)
[(1) taking hagrid's coat - silently]
You pick up hagrid's coat from the ground.

[(1) taking hagrid's coat - silently - succeeded]
[taking off hagrid's coat - failed the carrying requirements rule]

>get out from under coar
That noun did not make sense in this context.

>get out from under coat
[getting out from under hagrid's coat]
You get out from under hagrid's coat.

[getting out from under hagrid's coat - succeeded]

>get out from under coat
[getting out from under hagrid's coat]
You get out from under hagrid's coat.

[getting out from under hagrid's coat - succeeded]

>get under coatr
That noun did not make sense in this context.

>get under coat
[going under hagrid's coat]
You go under hagrid's coat.

[going under hagrid's coat - succeeded]

>look
[looking]
Shack (under hagrid's coat)
There is another small room to the east. a fire is crackling merrily in the grate.

You can see hagrid's coat, cake, Hagrid, Uncle Vernon, Aunt Petunia, sofa and fireplace (in which is fire) here.

[looking - succeeded]

>listen
[listening to Shack (under hagrid's coat)]
Hagrid is lying in a corner, snoring loudly.

there's nothing to hear.
[listening to Shack (under hagrid's coat) - succeeded]

* * *

>look coat
there are a whole bunch of pockets all around the coat. try opening a pocket.

>open pocket
You open one of the pockets at random, and find a large bunch of keys. Another pocket yields mint humbugs. Then you find slug pellets, and three more packets of sausages, before finally stumbling across a bag of strange-looking coins.

You open pocket.

>open pocket
That's already open.

>showme me
yourself - person
    letter - open container
    tea leaves
    teapot - open container
        water
    blanket
    glasses (worn)
    shirt (worn) - shirt
    pants (worn) - pants
location: in Shack
singular-named, proper-named; unlit, inedible, portable, ordinarily enumerated, seen, unfamiliar, not engaged, raw; male, awake
printed name: "Harry Potter"
printed plural name: "people"
indefinite article: none
description: "You're rather small and skinny for your age... the only thing you like about your appearance is your lighting shaped scar."
initial appearance: none
cost: 0 knute
carrying capacity: 100
posture: standing

>take bag of coins
You can't see any such thing.

>showme bag of coins
bag of coins - open container
    Knut - Knut
    Knut - Knut
    Knut - Knut
    Knut - Knut
    Knut - Knut
    Knut - Knut
    Knut - Knut
    Knut - Knut
    Knut - Knut
    Knut - Knut
    sickle - sickle
    sickle - sickle
    sickle - sickle
    sickle - sickle
    sickle - sickle
    sickle - sickle
    sickle - sickle
    sickle - sickle
    sickle - sickle
    sickle - sickle
    galleon - galleon
    galleon - galleon
    galleon - galleon
    galleon - galleon
    galleon - galleon
    galleon - galleon
    galleon - galleon
    galleon - galleon
    galleon - galleon
    galleon - galleon
location: out of play
singular-named, proper-named; unlit, inedible, portable, neuter, ordinarily enumerated, unseen, unfamiliar, not engaged, raw; opaque, open, unopenable, unlocked
printed name: "bag of coins"
printed plural name: "containers"
indefinite article: none
description: none
initial appearance: none
cost: 0 knute
carrying capacity: 100
posture: seated

>i
You are carrying letter, tea leaves, teapot and blanket. You are wearing glasses, a shirt and a pants.

* * *

>put 5 knuts in pouch
That noun did not make sense in this context.

>take 5 knuts
You can't see any such thing.

>look
Shack
There is another small room to the east. a fire is crackling merrily in the grate.

You can see owl, hagrid's coat, cake, a shack's door (west), Hagrid, Uncle Vernon, Aunt Petunia, Dudley, sofa, fireplace (in which is fire) and a window (empty) here.

>open coat
You open one of the pockets at random, and find a large bunch of keys. Another pocket yields mint humbugs. Then you find slug pellets, and three more packets of sausages, before finally stumbling across a bag of strange-looking coins.

>open bag
The owl holds out its leg, displaying a little, open pouch. It watches you expectantly.

>put 5 knuts in pouch
That noun did not make sense in this context.

>take 5 knuts
Knut: 
You take the Knut from bag of coins.
Knut: 
You take the Knut from bag of coins.
Knut: 
You take the Knut from bag of coins.
Knut: 
You take the Knut from bag of coins.
Knut: 
You take the Knut from bag of coins.

>put 5 knuts in pouch
Knut: 
Done.
Knut: 
Done.
Knut: 
Done.
Knut: 
Done.
Knut: 
Done.

The owl flutters out the open window. Hagrid gets up, yawning loudly, and says "Best be off Harry. Lots to do." He notices you looking at the coins in the bag, and says "I wouldn' worry 'bout money; Your parents left you some. It's in the wizard's bank, Gringotts.  We'll go there soon enough."

>look
Shack
There is another small room to the east. a fire is crackling merrily in the grate.

You can see hagrid's coat, cake, a shack's door (west), Hagrid, Uncle Vernon, Aunt Petunia, Dudley, sofa, fireplace (in which is fire) and a window (empty) here.

* * *

>open pocket
You open one of the pockets at random, and find a large bunch of keys. Another pocket yields mint humbugs. Then you find slug pellets, and three more packets of sausages, before finally stumbling across a bag of strange-looking coins.

* * *

>open bag
The owl holds out its leg, displaying a little, open pouch. It watches you expectantly.

>look bag
In bag of coins are ten Knuts, ten sickles and ten galleons.

>take 6 knuts
Knut: 
You take the Knut from bag of coins.
Knut: 
You take the Knut from bag of coins.
Knut: 
You take the Knut from bag of coins.
Knut: 
You take the Knut from bag of coins.
Knut: 
You take the Knut from bag of coins.
Knut: 
You take the Knut from bag of coins.

>put 6 knuts in bag of coins
Knut: 
Done.
Knut: 
Done.
Knut: 
Done.
Knut: 
Done.
Knut: 
Done.
Knut: 
Done.

>i
You are carrying letter, tea leaves, teapot and blanket. You are wearing glasses, a shirt and a pants.

>showme me
yourself - person
    letter - open container
    tea leaves
    teapot - open container
        water
    blanket
    glasses (worn)
    shirt (worn) - shirt
    pants (worn) - pants
location: in Shack
singular-named, proper-named; unlit, inedible, portable, ordinarily enumerated, seen, unfamiliar, not engaged, raw; male, awake
printed name: "Harry Potter"
printed plural name: "people"
indefinite article: none
description: "You're rather small and skinny for your age... the only thing you like about your appearance is your lighting shaped scar."
initial appearance: none
cost: 6 knutes
carrying capacity: 100
posture: standing

>take 6 knuts
Knut: 
You take the Knut from bag of coins.
Knut: 
You take the Knut from bag of coins.
Knut: 
You take the Knut from bag of coins.
Knut: 
You take the Knut from bag of coins.
Knut: 
You take the Knut from bag of coins.
Knut: 
You take the Knut from bag of coins.

>put 5 knuts in pouch
Knut: 
Done.
Knut: 
Done.
Knut: 
Done.
Knut: 
Done.
Knut: 
Done.

The owl flutters out the open window. Hagrid gets up, yawning loudly, and says "Best be off Harry. Lots to do." He notices you looking at the coins in the bag, and says "I wouldn' worry 'bout money; Your parents left you some. It's in the wizard's bank, Gringotts.  We'll go there soon enough."

* * *

>open pocket
You open one of the pockets at random, and find a large bunch of keys. Another pocket yields mint humbugs. Then you find slug pellets, and three more packets of sausages, before finally stumbling across a bag of strange-looking coins.

>open bag of coins
The owl holds out its leg, displaying a little, open pouch. It watches you expectantly.

>take 6 knuts
Knut: 
You take the Knut from bag of coins.
Knut: 
You take the Knut from bag of coins.
Knut: 
You take the Knut from bag of coins.
Knut: 
You take the Knut from bag of coins.
Knut: 
You take the Knut from bag of coins.
Knut: 
You take the Knut from bag of coins.

hi

>put 5 knuts in pouch
Knut: 
Done.
Knut: 
Done.
Knut: 
Done.
Knut: 
Done.
Knut: 
Done.

The owl flutters out the open window. Hagrid gets up, yawning loudly, and says "Best be off Harry. Lots to do." He notices you looking at the coins in the bag, and says "I wouldn' worry 'bout money; Your parents left you some. It's in the wizard's bank, Gringotts.  We'll go there soon enough."

hi

>put knut in bag of coins
You can't see any such thing.

>i
You are carrying a Knut, letter, tea leaves, teapot and blanket. You are wearing glasses, a shirt and a pants.

>put 1 knut in bag
You can't see any such thing.

>drop knut
Dropped.

>put knut in bag
You can't see any such thing.

>take knut
You pick up the Knut from the ground.

>look
Shack
There is another small room to the east. a fire is crackling merrily in the grate.

You can see hagrid's coat, cake, a the shack's door (west), Hagrid, Uncle Vernon, Aunt Petunia, Dudley, sofa, fireplace (in which is fire) and a window (empty) here.

>look bag
You can't see any such thing.

>open pocket
That's already open.

>look in pocket
Pocket is empty.

* * *

>w
"Now, I don't understand this muggle money," says Hagrid. "Can you please go and buy tickets from the machine? Here's some money."

(first standing up)

station
a greyish, gloomy room presents itself to you. The train tracks run along one side.

You can see train timetable and ticket machine (closed) (in which is tickets) here.

>get in boat
Hagrid jumps in the boat next to you, squishing you against the side. He looks at the boat. "Seems a shame to row", he says. He glances over his shoulder, before saying "If I sped things up a bit, would you mind not mentioning it at Hogwarts?"
"Sure," you say. Hagrid retrieves his pink umbrella from inside his coat and taps the side of the boat. The boat sped away towards the harbour. "Hagrid, what's a muggle?"

"It's what we call non-magic folk, and your family are the biggest group o' muggles I've ever seen, and I don't just mean physical size!"

"What about my parents?" you ask.
Hagrid sighs. "Your parents were a great witch and wizard, but even the greatest aren't invulnerable.  I can't tell yeh everythin', Because no-one knows all of it... 
It begins with a person called - called -"
"Called what?" you ask.

"Blimey, it's incredible you don't know his name, everyone in our world does - I don' like sayin' the name if I don't have to, and I'm not alone in that."

"Why not?"

"Because people are still scared, even after all this time... See, there was this wizard who went... bad. As bad as you could go. His name was... was 
"Was what?"

Voldemort." Hagrid shuddered.

>look
street (in boat)
In boat you can see Hagrid.

* * *

>w
"Now, I don't understand this muggle money," says Hagrid. "Can you please go and buy tickets from the machine? Here's some money."

(first standing up)

station
a greyish, gloomy room presents itself to you. The train tracks run along one side.

You can see train timetable and ticket machine (closed) (in which is tickets) here.

>get in
Hagrid jumps in the boat next to you, squishing you against the side. He looks at the boat. "Seems a shame to row", he says. He glances over his shoulder, before saying "If I sped things up a bit, would you mind not mentioning it at Hogwarts?"
"Sure," you say. Hagrid retrieves his pink umbrella from inside his coat and taps the side of the boat. The boat sped away towards the harbour. "Hagrid, what's a muggle?"

"It's what we call non-magic folk, and your family are the biggest group o' muggles I've ever seen, and I don't just mean physical size!"

"What about my parents?" you ask.
Hagrid sighs. "Your parents were a great witch and wizard, but even the greatest aren't invulnerable.  I can't tell yeh everythin', Because no-one knows all of it... 
It begins with a person called - called -"
"Called what?" you ask.

"Blimey, it's incredible you don't know his name, everyone in our world does - I don' like sayin' the name if I don't have to, and I'm not alone in that."

"Why not?"

"Because people are still scared, even after all this time... See, there was this wizard who went... bad. As bad as you could go. His name was... was 
"Was what?"

"Voldemort." 
Hagrid shuddered. "Anyway, about 20 years ago, he started gathering followers, and he found loads of people. Some afraid, and some just power hungry, because he had power. Dark days, Harry. Didn't know who you could trust. Hogwarts was one o' the only safe places left, because of Dumbledore, the headmaster. Your mum and dad were at Hogwarts then, and as good a witch and wizard as I ever knew. They were close to Dumbledore. 
And then, one day, at Hallowe'en ten years ago, he went to find them. He came to your house, and -"
Hagrid pulled a spotted handkerchief out of his pocket and blew his nose. 
"You-know-who killed your parents. And then - and this is the mysterious bit - he tried to kill you too. Turned his wand on you, and ended up destroying himself, while you just got a scar. No one knows what happened to him afterwards, except that he hasn't been seen since. I took you from the house personally, took you to the muggles, and you'd know the rest better than I would," he says, sighing.

>look
street (in boat)
In boat you can see Hagrid.

>get out
You get out of boat.

street
You can see boat (in which is Hagrid) here.

* * *

>w
"Now, I don't understand this muggle money," says Hagrid. "Can you please go and buy tickets from the machine? Here's some money."

(first standing up)

station
a greyish, gloomy room presents itself to you. The train tracks run along one side.

You can see train timetable and ticket machine (closed) (in which is tickets) here.

I beg your pardon?

>look tracks
Long, greyish metal bars the train runs on. Hagrid marvels at them as well.

>look track
Long, greyish metal bars the train runs on. Hagrid marvels at them as well.

>look timetable
The next train is to London, in 3 minutes.

>wait
Time passes.

>look timetable
The next train is to London, in 1 minute.

>buy tickets
You can't see any such thing.

>i
You are carrying muggle money, letter, tea leaves, teapot and blanket. You are wearing glasses, a shirt and a pants.

>showme station
station - room
    yourself - person
        muggle money
        letter - open container
        tea leaves
        teapot - open container
            water
        blanket
        glasses (worn)
        shirt (worn) - shirt
        pants (worn) - pants
    train tracks
    train timetable
    ticket machine - closed container
        *tickets
* denotes things which are not in scope
singular-named, improper-named; lighted, visited, posture-friendly
printed name: "station"
printed plural name: none
indefinite article: none
description: "a greyish, gloomy room presents itself to you. The train tracks run along one side."
map region: public streets

>buy tickets
You can't see any such thing.

* * *

>w
"Now, I don't understand this muggle money," says Hagrid. "Can you please go and buy tickets from the machine? Here's some money."

(first standing up)

station
a greyish, gloomy room presents itself to you. The train tracks run along one side.

You can see train timetable and ticket machine (closed) (in which is tickets) here.

>buy tickets
you pay the machine for the ticket.

>buy ticket
Nothing is on sale.

>but tickets
That's not a verb I recognise.

>buy tickets
you pay the machine for the ticket.

>look
station
a greyish, gloomy room presents itself to you. The train tracks run along one side.

You can see train timetable and ticket machine (closed and empty) here.

>look timetable
The next train is to London, in 3 minutes.

>i
You are carrying tickets, letter, tea leaves, teapot and blanket. You are wearing glasses, a shirt and a pants.

>buy tickets
Nothing is on sale.

>look
station
a greyish, gloomy room presents itself to you. The train tracks run along one side.

You can see train timetable and ticket machine (closed and empty) here.

* * *

>look people
You can't see any such thing.

>look passers-by
They look away quickly as you look at them.

>take passers-by
I don't suppose they would care for that.

>scenes
Scene 'Entire Game' playing (for -108 mins now)
Scene 'Dudley's birthday breakfast' ended
Scene 'zoo' ended
Scene 'Camera challenge' ended
Scene 'zoo aftermath' ended
Scene 'letters from no-one' ended
Scene 'post' ended
Scene 'Hagrid's scene' ended
Scene 'Diagonalley' playing (for 4 mins now)
(Scene monitoring now switched on. Type "scenes off" to switch it off again.)

>look
street
You can see Hagrid, boat (empty) and Passers-by here.

>w
(first standing up)

station
a greyish, gloomy room presents itself to you. The train tracks run along one side.

You can see train timetable and ticket machine here.

>look timetable
The next train is to London, in 5 minutes.

>look timetable
The next train is to London, in 4 minutes.

>look timetable
The next train is to London, in 3 minutes.

>look timetable
The next train is to London, in 2 minutes.

>look timetable\\
The next train is to London, in 1 minute.

>look timetable
The next train is to London, coming now.

>take timetable.
That's fixed in place.

>look machin
You can't see any such thing.

>look machine
The machine says that it is 2 pounds for a ticket.

>buy ticket
Nothing is on sale.

>buy machine
Nothing is on sale.

* * *

>i
You are carrying tickets, letter, tea leaves, teapot and blanket. You are wearing glasses, a shirt and a pants.

>read letter
You unfold the letter and read: 

HOGWARTS SCHOOL OF WITHCRAFT AND WIZADRY

Headmaster: Albus Dumbledore
(Order of Merlin, First Class, Grand Sorc., Chf. Warlock,
Supreme Mugwump, International Confed. of Wizards

Dear Mr Potter,
    We are pleased to inform you that you have a place at Hogwarts School of Witchcraft and Wizardry. Please find enclosed a list of all necessary books and equipment.
    Term begins on 1 September. We await your owl by no later than 31 July. 

Yours sincerely,

Minerva McGonagall
Deputy Headmistress.

In letter is school list.

>open letter
That's already open.

>look in letter
In letter is school list.

>look
station (in train)
a greyish, gloomy room presents itself to you. The train tracks run along one side.

You can see timetable and ticket machine (closed and empty) here.

In train you can see Hagrid.

>read school list
HOGWARTS SCHOOL OF WITCHCRAFT AND WIZARDRY

Uniform
First year students will require:
    1. Three sets of plain work robes (black)
    2. One plain pointed hat (black) for day wear
    3. One pair of protective gloves (dragon hide or similar)
    4. One winter cloak (black, silver fastenings)
Please note that all pupils' clothes should carry name tags

Set Books
All students should have a copy of each of the following:
The standard Book of Spells (Grade 1)  by Miranda Goshawk
A History of Magic by Bathilda Bagshot
Magical Theory by Adalbert Waffling
A Beginner's Guide to  Transfiguration by Emeric Switch
One Thousand Magical Herbs and Fungi by Phyllida Spore
Magical Drafts and Potions by Arsenius Jigger
Fantastic Beasts and Where to Find Them by Newt Scamander
The Dark Forces: A Guide to Self-Protection by Quentin Trimble

Other Equipment
    1 wand
    1 cauldron (pewter, standard size 2)
    1 set glass or crystal phials
    1 telescope
    1 set brass scales

Students may also bring an owl OR a cat OR a toad

PARENTS ARE REMINDED THAT FIRST YEARS ARE NOT ALLOWED THEIR OWN BROOMSTICKS

"Can we buy all of this in London?" you ask. 
"If you know where to go", says Hagrid. Hey look, we're here!

diagon alley

>read school list
HOGWARTS SCHOOL OF WITCHCRAFT AND WIZARDRY

Uniform
First year students will require:
    1. Three sets of plain work robes (black)
    2. One plain pointed hat (black) for day wear
    3. One pair of protective gloves (dragon hide or similar)
    4. One winter cloak (black, silver fastenings)
Please note that all pupils' clothes should carry name tags

Set Books
All students should have a copy of each of the following:
The standard Book of Spells (Grade 1)  by Miranda Goshawk
A History of Magic by Bathilda Bagshot
Magical Theory by Adalbert Waffling
A Beginner's Guide to  Transfiguration by Emeric Switch
One Thousand Magical Herbs and Fungi by Phyllida Spore
Magical Drafts and Potions by Arsenius Jigger
Fantastic Beasts and Where to Find Them by Newt Scamander
The Dark Forces: A Guide to Self-Protection by Quentin Trimble

Other Equipment
    1 wand
    1 cauldron (pewter, standard size 2)
    1 set glass or crystal phials
    1 telescope
    1 set brass scales

Students may also bring an owl OR a cat OR a toad

PARENTS ARE REMINDED THAT FIRST YEARS ARE NOT ALLOWED THEIR OWN BROOMSTICKS

>look
diagon alley
You can see Hagrid here.

* * *

>read list
HOGWARTS SCHOOL OF WITCHCRAFT AND WIZARDRY

Uniform
First year students will require:
    1. Three sets of plain work robes (black)
    2. One plain pointed hat (black) for day wear
    3. One pair of protective gloves (dragon hide or similar)
    4. One winter cloak (black, silver fastenings)
Please note that all pupils' clothes should carry name tags

Set Books
All students should have a copy of each of the following:
The standard Book of Spells (Grade 1)  by Miranda Goshawk
A History of Magic by Bathilda Bagshot
Magical Theory by Adalbert Waffling
A Beginner's Guide to  Transfiguration by Emeric Switch
One Thousand Magical Herbs and Fungi by Phyllida Spore
Magical Drafts and Potions by Arsenius Jigger
Fantastic Beasts and Where to Find Them by Newt Scamander
The Dark Forces: A Guide to Self-Protection by Quentin Trimble

Other Equipment
    1 wand
    1 cauldron (pewter, standard size 2)
    1 set glass or crystal phials
    1 telescope
    1 set brass scales

Students may also bring an owl OR a cat OR a toad

PARENTS ARE REMINDED THAT FIRST YEARS ARE NOT ALLOWED THEIR OWN BROOMSTICKS

>look
leaky cauldron
The leaky cauldron is small, dark and shabby. A few old women sit in one corner, drinking sherry. The barman was talking to a little man in a top hat. Everyone seems to know Hagrid. 

You can see Hagrid, Tom, Dedalus Diggle, Professor Quirrell, Doris Crockford, a small table, four chairs and a chair (on which is Old women) here.

* * *

>buy drink
Tom turns around to make you the drink, revealing a button on the wall.

>buy drink
Tom turns around to make you a drink, revealing a button on the wall.

>showme current action
There seems to be no such object anywhere in the model world.

>look
leaky cauldron
The leaky cauldron is small, dark and shabby. A few old women sit in one corner, drinking sherry. The barman was talking to a little man in a top hat. Everyone seems to know Hagrid. 

You can see Hagrid, a rusty old door (east), Tom, button, bar (on which is drink), Dedalus Diggle, Professor Quirrell, Doris Crockford, a small table, five chairs and five old women here.

Tom moves back over to his spot.

>buy drink
Tom turns around to make you a drink, revealing a button on the wall.

>buy afgsrtdhyf
Tom turns around to make you a afgsrtdhyf, revealing a button on the wall.

>ask tom for a drink
Tom moves back over to his spot.

Tom turns around to make you a drink, revealing a button on the wall.

>actions
Actions listing on.

>ask tom for a drink
[requesting Tom for drink]
Tom turns around to make you a drink, revealing a button on the wall.
[requesting Tom for drink - ended without result]

>ask tom for a drink
[requesting Tom for drink]
Tom turns around to make you a drink, revealing a button on the wall.
[requesting Tom for drink - ended without result]

>rules
Rules tracing now switched on. Type "rules off" to switch it off again, or "rules all" to include even rules which do not apply.

>ask tom for a drink
[Rule "after reading a command when the location is leaky cauldron" applies.]
[requesting Tom for drink]
[Rule "before doing anything" applies.]
[Rule "before doing anything" applies.]
[Rule "instead of requesting tom for something" applies.]
Tom turns around to make you a drink, revealing a button on the wall.
[requesting Tom for drink - ended without result]

[Rule "every turn during diagonalley" applies.]
[Rule "every turn during diagonalley" applies.]

* * *

>rules off
[Rule "after reading a command when the location is leaky cauldron" applies.]
Rules tracing now switched off. Type "rules" to switch it on again.

>look
[looking]
leaky cauldron
The leaky cauldron is small, dark and shabby. A few old women sit in one corner, drinking sherry. The barman was talking to a little man in a top hat. Everyone seems to know Hagrid. 

You can see Hagrid, a rusty old door (east), Tom, bar (on which is drink), Dedalus Diggle, Professor Quirrell, Doris Crockford, a small table, five chairs and five old women here.

[looking - succeeded]

>press button
[pushing button]
Tom is in the way
[pushing button - succeeded]

>buy asdgf
Tom turns around to make you a asdgf, revealing a button on the wall.

>look
[looking]
leaky cauldron
The leaky cauldron is small, dark and shabby. A few old women sit in one corner, drinking sherry. The barman was talking to a little man in a top hat. Everyone seems to know Hagrid. 

You can see Hagrid, a rusty old door (east), Tom, button, bar (on which is drink), Dedalus Diggle, Professor Quirrell, Doris Crockford, a small table, five chairs and five old women here.

Tom moves back over to his spot.
[looking - succeeded]

* * *

>buy drink
Tom turns around to make you the drink, revealing a button on the wall.

>press button
You press the button.

Tom moves back over to his spot. 
"Here you go, here's your drink."

Nothing obvious happens.

>undo
leaky cauldron
[Previous turn undone.]

>rules
Rules tracing now switched on. Type "rules off" to switch it off again, or "rules all" to include even rules which do not apply.

>press the butotn
[Rule "after reading a command when the location is leaky cauldron" applies.]
You can't see any such thing.

>press button
[Rule "after reading a command when the location is leaky cauldron" applies.]
[Rule "before doing anything" applies.]
[Rule "before doing anything" applies.]
[Rule "can't push what's fixed in place rule" applies.]
[Rule "can't push scenery rule" applies.]
[Rule "can't push people rule" applies.]
[Rule "carry out pushing button" applies.]
You press the button.

[Rule "after doing anything in leaky cauldron" applies.]
Tom moves back over to his spot. 
"Here you go, here's your drink."

[Rule "report pushing rule" applies.]
Nothing obvious happens.

[Rule "every turn during diagonalley" applies.]
[Rule "every turn during diagonalley" applies.]

* * *

>look Tom
Tom, an old, bald and wizened gentleman, is the bartender of the leaky cauldron. Tom is standing with his back up against the wall. It looks like he's covering something.

* * *

>hello
You are already talking to Tom.

>ask
What do you want to ask about?

I beg your pardon?

>undo
leaky cauldron
[Previous turn undone.]

>look
leaky cauldron
The leaky cauldron is small, dark and shabby. A few old women sit in one corner, drinking sherry. The barman was talking to a little man in a top hat. Everyone seems to know Hagrid. 

You can see Hagrid, a rusty old door (east), Tom, bar (on which is drink), Dedalus Diggle, Professor Quirrell, Doris Crockford, a small table, five chairs and five old women here.

>rules
Rules tracing now switched on. Type "rules off" to switch it off again, or "rules all" to include even rules which do not apply.

>hello tom
[Rule "after reading a command when the location is leaky cauldron" applies.]
[Rule "before doing anything" applies.]
[Rule "before doing anything" applies.]
[Rule "can't greet current interlocutor rule" applies.]
You are already talking to Tom.

[Rule "every turn during diagonalley" applies.]
[Rule "every turn during diagonalley" applies.]

>undo
leaky cauldron
[Previous turn undone.]

>undo
leaky cauldron
[Previous turn undone.]

>uno
That's not a verb I recognise.

>undo
leaky cauldron
[Previous turn undone.]

I beg your pardon?

* * *

>undo
leaky cauldron
[Previous turn undone.]

>undo
station
[Previous turn undone.]

>look
station (in train)
a greyish, gloomy room presents itself to you. The train tracks run along one side.

You can see timetable and ticket machine (closed and empty) here.

In train you can see Hagrid.

>report error "Train shouldn't stay in station while you talk to Hagrid".
Error noted.

>read list
HOGWARTS SCHOOL OF WITCHCRAFT AND WIZARDRY

Uniform
First year students will require:
    1. Three sets of plain work robes (black)
    2. One plain pointed hat (black) for day wear
    3. One pair of protective gloves (dragon hide or similar)
    4. One winter cloak (black, silver fastenings)
Please note that all pupils' clothes should carry name tags

Set Books
All students should have a copy of each of the following:
The standard Book of Spells (Grade 1)  by Miranda Goshawk
A History of Magic by Bathilda Bagshot
Magical Theory by Adalbert Waffling
A Beginner's Guide to  Transfiguration by Emeric Switch
One Thousand Magical Herbs and Fungi by Phyllida Spore
Magical Drafts and Potions by Arsenius Jigger
Fantastic Beasts and Where to Find Them by Newt Scamander
The Dark Forces: A Guide to Self-Protection by Quentin Trimble

Other Equipment
    1 wand
    1 cauldron (pewter, standard size 2)
    1 set glass or crystal phials
    1 telescope
    1 set brass scales

Students may also bring an owl OR a cat OR a toad

PARENTS ARE REMINDED THAT FIRST YEARS ARE NOT ALLOWED THEIR OWN BROOMSTICKS

"Can we buy all of this in London?" you ask. 
"If you know where to go", says Hagrid. "Hey look, we're here!"
Hagrid pulls you off the train and into a small bar. "This, Harry, is the leaky cauldron."
leaky cauldron
The leaky cauldron is small, dark and shabby. A few old women sit in one corner, drinking sherry. The barman was talking to a little man in a top hat. Everyone seems to know Hagrid. 

You can see a rusty old door (east), Tom, bar (on which is drink), Dedalus Diggle, Professor Quirrell, Doris Crockford, a small table, five chairs and five old women here.

The barman asks "The usual, Hagrid?"
"Can't. Tom, I'm on Hogwarts Business. I'm taking Harry here to buy his school things."

The room goes quiet. "Good lord. Can it be... can it be Harry Potter?"
What seems like the entire bar queues up to shake your hand; some keep coming back. 
"Welcome back Mr Potter, Welcome back!"
"So proud, Mr Potter, I'm just so proud - "
"P-P-Potter, c-can't tell you how p-pleased I am to meet you."
"Harry, this is Professor Quirrell. He's a Hogwarts teacher." says Hagrid.

>rules
Rules tracing now switched on. Type "rules off" to switch it off again, or "rules all" to include even rules which do not apply.

>actions
[Rule "after reading a command when the location is leaky cauldron" applies.]
Actions listing on.

>hello tom
[Rule "after reading a command when the location is leaky cauldron" applies.]
[saying hello to Tom]
[Rule "before doing anything" applies.]
[Rule "before doing anything" applies.]
[Rule "note current interlocutor when greeted rule" applies.]
[Rule "after doing anything in leaky cauldron" applies.]
[saying hello to Tom - succeeded]

[Rule "every turn during diagonalley" applies.]
[Rule "every turn during diagonalley" applies.]

>rules off
[Rule "after reading a command when the location is leaky cauldron" applies.]
Rules tracing now switched off. Type "rules" to switch it on again.

>actions off
Actions listing off.

>look
leaky cauldron
The leaky cauldron is small, dark and shabby. A few old women sit in one corner, drinking sherry. The barman was talking to a little man in a top hat. Everyone seems to know Hagrid. 

You can see Hagrid, a rusty old door (east), Tom, bar (on which is drink), Dedalus Diggle, Professor Quirrell, Doris Crockford, a small table, five chairs and five old women here.

>buy drink
Tom turns around to make you a drink, revealing a button on the wall.

>press button
You press the button.

Tom moves back over to his spot. 
"Here you go, here's your a drink."

>buy asdf
Tom turns around to make you a asdf, revealing a button on the wall.

>look
leaky cauldron
The leaky cauldron is small, dark and shabby. A few old women sit in one corner, drinking sherry. The barman was talking to a little man in a top hat. Everyone seems to know Hagrid. 

You can see Hagrid, a rusty old door (east), Tom, button, bar (on which is drink), Dedalus Diggle, Professor Quirrell, Doris Crockford, a small table, five chairs and five old women here.

Tom moves back over to his spot. 
"Here you go, here's your a drink."

* * *

>test
>--> The following tests are available:
'test me'
Name:

* * *

>look
Shack
There is another small room to the east. a fire is crackling merrily in the grate.

You can see owl, hagrid's coat, cake, a the shack's door (west), Hagrid, Uncle Vernon, Aunt Petunia, Dudley, sofa, fireplace (in which is fire) and a window (empty) here.

>open pocket
You open one of the pockets at random, and find a large bunch of keys. Another pocket yields mint humbugs. Then you find slug pellets, and three more packets of sausages, before finally stumbling across a bag of strange-looking coins.

* * *

>look
Shack
There is another small room to the east. a fire is crackling merrily in the grate.

You can see hagrid's coat, cake, owl, a the shack's door (west), Hagrid, Uncle Vernon, Aunt Petunia, Dudley, sofa, fireplace (in which is fire) and a window (empty) here.

>take 1 sickle
You take the sickle from bag of coins.

sickleloss

* * *

I beg your pardon?

Name:

Welcome to An Interactive Fiction version of Harry Potter.
                (If you ever need help, type help. You can also access Settings through the help menu)

The room held no sign at all that another boy lived in the house too.
    Yet Harry Potter was still there, asleep at the moment, but not for long. His Aunt Petunia was awake and it was her shrill voice which made the first noise of the day.

Up! Get up! Now!

Harry Potter and the Philosopher's Stone
Based on by "Harry Potter and the Philosopher's stone" by J.K. Rowling. This game is not approved by J. K. Rowling. It exists because I am a fan of Harry Potter and text adventures, and is not a commercial venture. by Orion Zymaris
Release 1 / Serial number 131210 / Inform 7 build 6G60 (I6/v6.32 lib 6/12N) SD
Cupboard under the stairs
You can see a small, dark room with lots of spiders and your few measly possessions. Not as interesting as the dream you were having - There had been a flying motorbike in it. You have a funny feeling that you've had the same dream before...

You can see Cupboard door (south), Bed (empty), a pair of socks, a pair of shoes, some assorted clothing, a chess set and a roll of sellotape here.

Name:

>Orion
Your name for this pre-release test is "Orion".

>look
Cupboard under the stairs
You can see a small, dark room with lots of spiders and your few measly possessions. Not as interesting as the dream you were having - There had been a flying motorbike in it. You have a funny feeling that you've had the same dream before...

You can see Cupboard door (south), Bed (empty), a pair of socks, a pair of shoes, some assorted clothing, a chess set and a roll of sellotape here.

>look
Cupboard under the stairs
You can see a small, dark room with lots of spiders and your few measly possessions. Not as interesting as the dream you were having - There had been a flying motorbike in it. You have a funny feeling that you've had the same dream before...

You can see Cupboard door (south), Bed (empty), a pair of socks, a pair of shoes, some assorted clothing, a chess set and a roll of sellotape here.

>look
Cupboard under the stairs
You can see a small, dark room with lots of spiders and your few measly possessions. Not as interesting as the dream you were having - There had been a flying motorbike in it. You have a funny feeling that you've had the same dream before...

You can see Cupboard door (south), Bed (empty), a pair of socks, a pair of shoes, some assorted clothing, a chess set and a roll of sellotape here.

"Up!" Screeches Petunia.

>settings
 > General Game Commands (for specific hints, type hints)
   Settings
   What does that top bar do?
   Acknowledgements
   Itinerary

* * *

   General Game Commands (for specific hints, type hints)
 > Settings
   What does that top bar do?
   Acknowledgements
   Itinerary
   
   General Game Commands (for specific hints, type hints)
 > Settings
   What does that top bar do?
   Acknowledgements
   Itinerary

 > Time delays are on

 > Time delays are off
 > Time delays are off

 > Time delays are on
 > Time delays are on

* * *

>q
   General Game Commands (for specific hints, type hints)
 > Settings
   What does that top bar do?
   Acknowledgements
   Itinerary

>q
Cupboard under the stairs
You can see a small, dark room with lots of spiders and your few measly possessions. Not as interesting as the dream you were having - There had been a flying motorbike in it. You have a funny feeling that you've had the same dream before...

You can see Cupboard door (south), Bed (empty), a pair of socks, a pair of shoes, some assorted clothing, a chess set and a roll of sellotape here.

* * *

I beg your pardon?

Name:

>\\
Harry Potter and the Philosopher's Stone
Based on by "Harry Potter and the Philosopher's stone" by J.K. Rowling. This game is not approved by J. K. Rowling. It exists because I am a fan of Harry Potter and text adventures, and is not a commercial venture. by Orion Zymaris
Release 1 / Serial number 131210 / Inform 7 build 6G60 (I6/v6.32 lib 6/12N) SD
Cupboard under the stairs
You can see a small, dark room with lots of spiders and your few measly possessions. Not as interesting as the dream you were having - There had been a flying motorbike in it. You have a funny feeling that you've had the same dream before...

You can see Cupboard door (south), Bed (empty), a pair of socks, a pair of shoes, some assorted clothing, a chess set and a roll of sellotape here.

Name:

>Orion
Your name for this pre-release test is "Orion".

* * *

>look
Cupboard under the stairs
You can see a small, dark room with lots of spiders and your few measly possessions. Not as interesting as the dream you were having - There had been a flying motorbike in it. You have a funny feeling that you've had the same dream before...

You can see Cupboard door (south), Bed (empty), a pair of socks, a pair of shoes, some assorted clothing, a chess set and a roll of sellotape here.

>get up
You are already standing.

>look
Cupboard under the stairs
You can see a small, dark room with lots of spiders and your few measly possessions. Not as interesting as the dream you were having - There had been a flying motorbike in it. You have a funny feeling that you've had the same dream before...

You can see Cupboard door (south), Bed (empty), a pair of socks, a pair of shoes, some assorted clothing, a chess set and a roll of sellotape here.

* * *

>purloin school list
Your name for this pre-release test is "purloin school list".

>purloin school list
[Purloined.]

>read list
HOGWARTS SCHOOL OF WITCHCRAFT AND WIZARDRY

Uniform
First year students will require:
    1. Three sets of plain work robes (black)
    2. One plain pointed hat (black) for day wear
    3. One pair of protective gloves (dragon hide or similar)
    4. One winter cloak (black, silver fastenings)
Please note that all pupils" clothes should carry name tags

* * *

>inventory
Your name for this pre-release test is "inventory".

>look
Cupboard under the stairs (in Bed)
You can see a small, dark room with lots of spiders and your few measly possessions. Not as interesting as the dream you were having - There had been a flying motorbike in it. You have a funny feeling that you've had the same dream before...

You can see Cupboard door (south), a pair of socks, a pair of shoes, some assorted clothing, a chess set and a roll of sellotape here.

>examine spiders
You can't see any such thing.

>report error in cupboard under stairs, add spider examination
Error noted.

>take all
pair of socks: You pick up the pair of socks from the ground.

"Up!" Screeches Petunia.

pair of shoes: You pick up the pair of shoes from the ground.

assorted clothing: You pick up the assorted clothing from the ground.

chess set: You pick up the chess set from the ground.

roll of sellotape: You pick up the roll of sellotape from the ground.

>yell at petunia
That's not a verb I recognise.

>yes
There's no one here to talk to.

>report error make sure to put on shoes and socks before leaving the cupboard under the stairs
Error noted.

>report error make it so you can place the assorted clothing into the laundry basket
Error noted.

>open door
You open Cupboard door.

>leave
You get out of Bed.

Cupboard under the stairs
You can see a small, dark room with lots of spiders and your few measly possessions. Not as interesting as the dream you were having - There had been a flying motorbike in it. You have a funny feeling that you've had the same dream before...

You can see Cupboard door (south) and Bed (empty) here.

>s
"Get a move on, I want you to look after the bacon. And don't you dare let it burn, I want everything perfect on Duddy's birthday." 
You see the kitchen door slam as Petunia walks through and closes it. The sound of the frying pan being put on the cooker emenates from the kitchen. You'd better cook the breakfast.

Hall
You can see Staircase (up), a Dining room door (southwest), the living-room door (south), front door (east), kitchen door (west) and Cupboard door (north) here.

>up
Landing
You can see attic stairs (up), Dudley's second room door (northeast), Dudley's bedroom door (northwest), Dursley's bedroom door (southeast) and Staircase (down) here.

>nw
(first opening Dudley's bedroom door)

Dudley's bedroom
You can see Dudley's bedroom door (southeast) and a set of drawers here.

>leave room
I only understood you as far as wanting to leave.

>leave
You are already standing.

>se
Landing
You can see Dudley's bedroom door (northwest), Dursley's bedroom door (southeast), Staircase (down), attic stairs (up) and Dudley's second room door (northeast) here.

>up
attic
As you enter the attic, you see pictures of Dudley all over the walls.

You can see attic stairs (down), dusty box (closed) and some random objects here.

>open box
You open dusty box, revealing three toys, and books with titles such as the how to spoil your children handbook, drills- an unabridged history, 101 Pompous Complaints, a High calorie cookbook and a smeltings schoolbook.

>report error make it so you can't take the objects from the box, "Uncle Vernon would kill you if he found that you had stolen this"
Error noted.

>down
Landing
You can see attic stairs (up), Dudley's second room door (northeast), Dudley's bedroom door (northwest), Dursley's bedroom door (southeast) and Staircase (down) here.

>down
Hall
You can see Staircase (up), a Dining room door (southwest), the living-room door (south), front door (east), kitchen door (west) and Cupboard door (north) here.

>sw
(first opening the Dining room door)

Dining room
You can see a living room door (east), a Dining room door (northeast), five chairs and dining room table here.

>e
(first opening the living room door)

Living-room
You can see a living room door (west), the living-room door (north), a mantlepiece (on which are five photos), Piano (on which is sheet music), Stool, Armchair, Couch and Television here.

>take all
Television: You pick up Television from the ground.

photo: You should leave these. They're family possessions. And Uncle Vernon would kill you if you took one.
photo: You should leave these. They're family possessions. And Uncle Vernon would kill you if you took one.
photo: You should leave these. They're family possessions. And Uncle Vernon would kill you if you took one.
photo: You should leave these. They're family possessions. And Uncle Vernon would kill you if you took one.
photo: You should leave these. They're family possessions. And Uncle Vernon would kill you if you took one.
sheet music: You take sheet music from Piano.

Aunt Petunia comes into the room and grabs you by the scruff of the neck, and drags you to the kitchen to cook Dudley's bacon.

kitchen
You see Dudley here, counting his presents.

You can see kitchen door (east), Uncle Vernon (hiding behind a newspaper), Aunt Petunia, Dudley, a chair, kitchen table (on which is piece of toast), thirty-seven presents, a cooker (on which is a the frying pan (in which are egg and bacon)), fridge (closed) and sink here.

>report error you can TAKE THE TELEVISION, REALLY?
Error noted.

>report error see if you can get rid of the "take all" option
You'd better not. Those are Dudley's.

>report error "youd better not those are dudleys"????
Error noted.

The telephone rings in the living room. Aunt Petunia goes to get it.

>take phone
You can't see any such thing.

>take
What do you want to take?

>yes
You need to specify who you want to speak to.

>look
kitchen
You see Dudley here, counting his presents.

You can see kitchen door (east), Uncle Vernon (hiding behind a newspaper), Dudley, a chair, kitchen table (on which is piece of toast), thirty-seven presents, a cooker (on which is a the frying pan (in which are egg and bacon)), fridge (closed) and sink here.

Aunt Petunia enters the kitchen looking angry and worried. "Bad news, Vernon. Mrs Figg's broken her leg. She can't take him" she says, jerking her head towards you. Dudley looks horrified. "He's not coming on my birthday!"

"Maybe you could just leave me here" you suggest. 

"And come back and find the house in ruins?" says Aunt Petunia.

"I won't blow up the house," you say.

"I suppose we could take him to the zoo, and leave him in the car," says Aunt Petunia.
"The car's new, he's not sitting in it alone..."
Dudley begins to cry loudly. He's not really crying, it's been years since he's done that, But he knows that Aunt Petunia will give him anything he wants if he does.

That's the doorbell. Must be Piers Polkiss, Dudley's friend. Dudley's stopped pretending to cry.
"Alright, let's go," says Petunia. Everyone leaves the kitchen and gets into the Dursley's car.

>report error can't cook eggs before they all leave to the car.
Error noted.

>report error if you don't cook eggs in time Aunt petunia should do it, but tell you that you won't get dinner for a week.
Error noted.

>look
kitchen
You can see kitchen door (east), a chair, kitchen table (on which is piece of toast), thirty-seven presents, a cooker (on which is a the frying pan (in which are egg and bacon)), fridge (closed) and sink here.

>save
Ok.

* * *

>conz
Your name for this pre-release test is "conz".

>get socks
You pick up the pair of socks from the ground.

>get shoes
You pick up the pair of shoes from the ground.

>wear shoes
What, with no socks?

>wear socks
You flick a spider off the socks and hurriedly put them on.

>wear shoes
You put on the pair of shoes.

>get sellotape
You pick up the roll of sellotape from the ground.

>look
Cupboard under the stairs (in Bed)
You can see a small, dark room with lots of spiders and your few measly possessions. Not as interesting as the dream you were having - There had been a flying motorbike in it. You have a funny feeling that you've had the same dream before...

You can see Cupboard door (south), some assorted clothing and a chess set here.

>s
You'll have to get out of Bed first.

>get out of bed
I only understood you as far as wanting to get outside.

>get up
You get out of Bed.

Cupboard under the stairs
You can see a small, dark room with lots of spiders and your few measly possessions. Not as interesting as the dream you were having - There had been a flying motorbike in it. You have a funny feeling that you've had the same dream before...

You can see Cupboard door (south), Bed (empty), some assorted clothing and a chess set here.

>s
(first opening Cupboard door)

Hall
You can see Staircase (up), a Dining room door (southwest), the living-room door (south), front door (east), kitchen door (west) and Cupboard door (north) here.

>save
Ok.